адъ - а-дъ
алчущш - кытынди а-воргу
алый - ня-ргенгь
амбаръ - кле-въ
ангелъ - а-нгеленъ
ангельскш - а-нгельди
аркать [натравлять, науськивать] - кы-рымбыгу
аршинъ - арсы-нъ
афонасий - панаса-
бабка - нима-
бабочка - ла-мбрека
баранъ - коне-рка
батюшка - а-ча-
бдение - а-нгу ча-нгванъ
бегающш - ко-рти
бегом бежать - о-рсе куро-лгу
бегущш - куро-лпыдимы
беда - беда-
бедный - нужнай, бе-днай
бедро - пе-лъ
бежать, [бе]гать - куро-лгу
безъ - га-лкъ (посло
сущ[ествительного])
безъ малого (столько-то) - супта-й
без оглядки - ма-ннембыгунчалкъ [ исправлено из ма-ннембыгун-ча-лкъ]
безъ отдыха - а-съ о-мдыку, о-тдыкангалкъ
безъ платы - да-ромъ
без принуждешя - о-нде во-леутъ
безъ просыпа - а-съ кы-льчикванъ
без сомнения - безсумле-нья
безъ успеха - т<о->кды (т<а->кды?) а-съ ми-дымбать
безъ утайки - та-умбыгалкъ
безъ чего нельзя жить - э-лгусанъ аз е-мъ
безъ числа - тэ-йгалкъ, та-гола [ строка зачеркнута]
безъ числа - тэ-йгалкъ, ка-ндыбынгъ
безводный - ё-тгыди
безделье - никако-й рабо-танъ ча-нгванъ
бездельникъ - безде-льникъ
бездна - ко-рынъ е-нгь кра-льди нэ-й ча-нгванъ
беззаконно - а-съ зако-ннанъ
беззубый - те-угыди
безначальный - у-гыгыди
безногш - то-пгыди
безносый - пу-чигыди
безответный - безотве-тнай
безропотно - дово-льнанъ э-зыгу
безрукий - у-тгыди
безумный -тэ-йгыди
беленый - бели-мбыди
беленьк|й - че-галандъ
белокурый - па-тнолъ
белый - те-гь, те-ганъ
берегъ - ке-нбаръ
береза - кюэ-
беременный жив[отное] - има-дырбанъ
беременный чел[овекъ] - на-ндже не-йгомъ
береста - твэ-
берестяное ведро - ко-рынджека
берестяный - твэ-й
берегись - а-рангурокъ
беречь - береги-мбыгу
беречь - караву-мбыгу
беречься - а-рангыргу
[беречь]ся - пи-ремтъ караву-мбыгу [строка зачеркнута]
бери - и-г<и>ты [строка зачеркнута]
беседовать - келеда-дыргу
беситься - мана-мбыгу
безконечный - та-быгыди
бесовскш - ло-зынзиди
безъплодный - чо-быргалкъ
безпокоить - безпоко-имгу
[безпокоить]ся - [безпоко-]итчигу
безпрепятственно - ку-дынъ нэ-й а-съ меса-имба
безпрестанно - а-съ у-тыркванъ
безсильный - о-румгыди
безславить - а-съ а-ндугу
безсловесный - ы-эчьгыди
безсмерт1е - безсме-ртыгатъ
безсмертный - сме-ртгыди
безсовестно -совестн<ан>га-лкъ
безсонница - а-съ ко-ндонангъ
безсонный - а-нгуди
безтелесный -ва-тьитча-кванди, ва-тьигыди
безценный - ме-ртегыди
безчест1е - стра-мъ
безчестить - безче-стимгу
бешеный - мана-мбыди [исправлено из ма-намбыди]
бисеръ - пюссе-й
битый - ква-тпыди
бить - ква-тгу
биться (о человеке больномъ) - ты-ргымбыгу
биться, драться - дра-кыса-тчигу
бич, кнутъ - ка-рсынъ
благоволить - а-рынь ко-мть сво-мы кы-гыгу
благодарить - благодари-мбыгу
благодатный - благода-тной
благодать - благода-ть
благоспеятися - сво-нъ ме-гугу
благочестивый - благочести-вой
благородный - сво- поро-дандо ко-м<ъ>
благоухан1е - путё-мъ сво- а-етъ
благочинно - поря-дкагынъ
блаженство - а-рынъ векогынъ сво- э-ланъ
блевать - тю-дугу
блевотина - тю-дунбыдимы
бледный - те-гынъ
бледнолицый - вандо-гентъ ка-внэ-й ча-нгванъ
блекнуть - тегенча-ннынбыгу
блестеть - чо-лгонбыгу
блестеть о зарнице - по-рымбыгу
блестящш - чо-лгонбыди
блеять - мё-генбыгу
близко - чардзе-канъ
близко (о времени) - а-съ кундо-кынъ, чардзе-канъ
ближе - чардзе-калагъ
ближн|й - чардзе-каги
блинъ - ала-ндя, блинъ
блистать - те-лыргу
блоха - сы-гтэ
блудъ - кю-дчидимы
блудникъ - бля-дь, кюдче-ди тебе-комъ
блудница - кюдче-ди не-йгомъ
блюдо - блю-до
боберъ - пучо-
бобровый - пучо-нпоби
богъ - Но-мъ
богатеть - ко-игу
богатить - ко-игуле мету
богато - ко-умбыле
богатство - ко-умбыдимы
богатство ума, богатство премудр[ости]- ко-умбыдильтэ-йдъ
богатый - коумбыди, зачеркнуто:] ко-умбыти
боги - нула
богиня - не-йно-мъ
богородица - богородиса
богомольный - Номтъ о-мтынди [комъ]
богомудрствовать - Но-мде тэ-йербыгу
богу даръ - но-мтъ ко-за
бодать, [бодать]ся - а-мтыгу
бодриться - со-гидде
бодрствовать - а-съ ко-ндолдженджигу
божба - не-вончимбыди
божественный - Ну-нъ
божш - ну-нъ
бож1Й даръ - Нунъ да-р<ъ1>
божиться - не-вончигу
бож1Я Матерь - Нун-ъ А-утъ
бокъ - кенджаръ, по-къ
болото - ка-льджъзанъ
болтать язык[омъ] - болта-йчигу
больнее - кё-зынлагъ
больно - кё-зынгъ
больной - месала-й
большая вода - ва-ргъ ё-тъ
большая дорога - ва-ргъ ва-тъ
больше - ва-ргылагъ
больше нежели - танна-нъ ко-чи манна-нъ та-нака енгъ
большой - ва-ргь е-нгь
болезнь - месала-нъенъ
болезнь не къ смерти - мессала-нъ енъ а-съ куссо-ди
боровъ живот[ное] - сыбындя-
борода - у-мде
борозда - кылба-
бороться - ора-лгу
босикомъ - пё-угалкъ
босой - нельде-нто-пынъ е-нгъ
ботинки - боти-нка
бочка - по-чка
боязнь - э-ллъ
бояться - ла-рымбыгу
бранить - ты-гу
браниться - ты-ндугу, кво-дымбыгу
брань, хула - ты-мба
братъ большой - ага-у
братъ въ разговоре (зв[ательный] пад[ежъ]) - бра-тъ
братъ меньш1Й - тимня-у
братъ общ[ее] назв[ан1е] - тимня-у, тимня-ла
братолюбивый - ве-сь свыо-рбыкунди
братскш -тимня-умъ
брать - и–гу
бревно - бро-вна
бредить во сне - ко-ндолгу <а-й> че-нчигу
бремя - са-тчименъ
бренчать - ке-ттелбыгу
бровь- се-йнъ-о-ндъ
бродить в воде - ю-ткынъ <да- >дыргу
бродни - бро-денъ
броня - кво-зи по-ркъ
бросать неводъ въ воду - по-тку
бросить, лукнуть - ча-джигу
бросить прочь - точа-джигу [ исправлено из тотя-жгу]
бросить якорь - я-корь ча-джигу
броситься - па-ктыргу
брусокъ - сыльджиса-пю
брызгать - ва-скыргу
брызгать рт[омъ] - пудолгу
брюхо - на-нчь
брюханъ - варна-тжи ко-мъ, ю-рсей, ка-бырледи
брюшина - по-унъ-о-лъ
бугоръ, холмъ - ма-кка
будто - бу-дто што-
будущая жизнь - а-рынгъ ве-къ
будущ|й - няндо-ни, нянней
будущш годъ - тита-ви по-дъ
буйный - те-ттенбыди
букашка - чу-къ
булавка - була-вка
бунтъ - пу-нтъ
бурный ветеръ - си-льнай мергыза-нъ
бурундукъ - се-пка
буря - пого-да
буря на море - мо-рянсе-рбатъ
буря на реке - ква-йенсе-рбатъ
бусы - ва-ргъ пюссе-й
бывать - э-зыгу, э-зембыгу
быкъ - бы-ка
быстрый - чандча-женъ, кю-<вв>ъ [зачеркнуто]
быт1е - э-<л>анъ
быть надменнымъ - ва-ргыльджигу
быть покорнымъ - поко-рнанъ э-зыгу, ю-нгольджигу
быть трезвымъ - а-съ ю-тку
въ глазу - се-йгынъ
въ другой разъ - сы-дымдж<еч>чи, а-урынгъ
въ немъ - та-быгынъ
въ немъ (о челов[еке]) - перге- гынъ
въ себе - о-ндегынъ
въ середине - сыдгоде-римы
въ томъ - на-угынъ
въ шапке - ё-къзе-е
въ этомъ месте - тындга-
валекъ - ча-чь
валяться - пю-нгульджигу
вареный - по-тпыдимы
варить - по-тку, э-ттергу
вбить - кэ-ттелгу
вбитый - кэ-ттелбыди
вверить - дове-римгу
вверхъ ногами - сугульча-
вверхъ реки - та-мы
вверху - и-нненъ
ввести, вводить - тоа-льджигу
ввести въ убытокъ - убы-тканзе та-нненъ
вдали - кундо-кынъ е-нгъ
вдвинуть - чо-голджигу
вдова - серы-мъ па-
вдоль - чу-мбынъ
вдругъ - туру-къ, па-бъ
вёдро - сво- Но-мъ
везде - везде-
велелепный - катку- а-съ мо-жнанъ е-нгъ
велеть - кура-льджигу
великш - ва-ргъ
великш Богъ - Ва-ргно-мъ
величайш|й умъ - путё-мъ- ва-ргъ тэ-й
величать - велича-имгу
величаться богатствомъ - ва-ргыльджигу
велич1е - ва-ргычга
велич1е бож1е - Ва-ргычга Нумъ
венокъ - вено-ка
веревка - пенько-ва
веретено - кю-тъ вбрить- ве-римгу
верный - ве-рнай вбровать -ве-рытынбыгу
вертеть, [вертеть]ся - ко-ирыгу
вертеться - ко-йватгу
верткш - вё-рткай е-нгъ
верхушка - пальчо-баръ
вершина дер[ева] - няргыно-лъ, поно-лъ
вершина дер[ева] - ню-къ
веселиться - весела-нненгу
веселый - весё-лай
весить - ва-тчигу
весло - ла-пъ
весна - ё-татъ
весновать - та-умгу
вести, водить - та-льджигу
вести жизнь - э-д<от>деква-ддыгу
весть - весте-й
весть дать - ве-стимъ ми-дыгу
весьма - кандыбынгъ, путё-мъ
ветка - кыба- мо-ла
ветеръ - мерга-нъ
ветеръ бурный - ва-ргъ ме-ргынъ
ветеръ воетъ - чу-ранъ
ветеръ возметаетъ - качку- ча-женъ
ветеръ гнетъ дер[ево] - ме-ркма-ныкотъ
ветеръ нач[алъ] дуть - ме-ргеле ю-бырзанъ
ветеръ подхват[илъ] и понесъ - ме-ргъ ква-тчимба а-й
ветеръ попутный - мого-лъ ме-ргъ
ветеръ противный - кве-се ме-ргъ
ветеръ развеваетъ - леле-етымбатъ
ветеръ реветъ - ла-нгыску
ветеръ съ востока - та-мынди ме-рганъ
ветеръ съ запада - та-нгынди ме-рганъ
ветеръ съ севера - а-ургынъ ме-рганъ
ветеръ съ юга - съюта ме-рганъ
ветеръ свиститъ - со-мнымбыгу
вечеръ - Но-мъ ю-демба
вечеръ - ю-демы
вечернш - ю-ди
вечеромъ - ю-демыганъ
вешалка - и-дыгу
взаменъ - нанго-птонъ
взаперти - кэ-ттенбыди
взбалмошный - мана-мбыди го- мъ
взбежать - куро-лгу
взвести кур[окъ] руж[ья] - са- ккумо- мдальджигу
взглянуть - мандже-чигу
взгромоздить - ва-ргынъ пы-ргынъ те-льджигу
вздохнуть - кво-яргу
взлесть - сы-голгу
взлететь - и-ннеква-нгу
взмутить - нынго-льджимбыгу
взятка - взя-тка
взять - и-гу
взять въ умъ - тэ-йрбыгу
взяться, ухватиться - и-гдыгу
взяться (за дело) - ора-лгу
видеть - ко-нджиргу
видеть во сне - кюде-птембыгу
вилка - пила-йгвозъ
вилы - пила-йпо-
вина - вина-
вино - ара-нка
виноватый - винова-нанъ е-нгъ
винтъ - ви-нтъ
висеть - ы-дыгу
високъ - нярымо-
вить веревку - па-нгылгу
вить гнездо - пё-тъ меледа-дыргу
вколотить - ка-ттылгу
вкопанный - па-кыльдимы
вкорениться - ко-ндж<ить> э-зыгу
вкусный - вку-шнай
владеть - владе-имгу
влезть во что - сы-рчигу
вливаться, течь - нё-реджелеча-жигу
вложить - пе-нбыгу
вменить, зачесть - о-мдальджигу
вместить въ себя - па-дчигу
вместить можетъ - мо-жотъ па-дчанъ
вместе - о-кыръ-мыгы-нъ
вместе, въ рядъ - кечё-льдчь
вместе съ собою - о-кырмыгы-нъ пи-ремтзе, ондызе
вместе съ темъ - о-кырмыгы-нъ та-узе
вместо - заме-ста
внести - то-тку
внести въ книгу - на-гыргу
внешний - поне-блекатъ
внизу - илле-ймы
внизъ реки - танны-
вникнуть- тэ-йербыгу
вновь, снова - са-ндынъ
внукъ - и-ндъи-
внутреннш - сю-ндзеней блекатъ
внутренность - сю-ндзенейбека-тъ
внутри - сю-ндзененъ
внучка - и-ндъи-
вовсе - ме-льдчь
вода - ё-тъ
вода большая - ва-ргъ ё-тъ
вода малая - кыба- ё-тъ
вод[а] прибывать - ме-чигу, мё-дзимбыгу
вода убывать - ку-зорымбыгу, ку-зорлеча-жигу
водвориться - ны-ндъ э-лгу
водить - та-льджигу
водить кругомъ - пю-ронгъ ко-ирыгу
водяная заводь - пальчо-
водянка болез[нь] - ю-тъ ча-жентъ
водяной - ё-ди
воевать - те-ттенбыгу, мю-т<ъ ч>а-жигу
вожжи - вазза-
возбранить - а-съ кура-льджигу
возбуждать - сы-дыгу
возбуждаться - сы-дычигу
возвестить - пакталгу, ве-стимъ ю-дыгу
возвратить - могне- ми-гу
воздержание - терпи-мбыдымы, пи-ремтъ у-турумбыдимы
воздерживаться - терпи-мгу, у-турымбыгу
воздухъ - кво-й, по-ра
[зачеркнуто]
воздушный - кво-йзю
возле - ко-йгынъ, кё-югей
возложить - пе-нгу
возлюбленный - свыо-рынди
возрадоваться - а-нталбыгу
возрастить - о-рынчугу
война - война-
войско - мю-тъ
войти - се-ргу
вокругъ - пю-ронъ е-нгъ
волкъ - тюмбне-
волна - валра-нъ
волноваться - ва-лугу, ва-лыргу
волны поднялись - ва-лырнанъ
волосъ - та-ръ, о-птъ
волосъ на гол[ове] - о-лынта-ръ, о-лыно-пте
волосогрыжица - о-птылчукъ
волочить - ютолбыгу [строка зачеркнута\
волочить по земле - чво-чегынъ ю-голгу
вольно - во-льнанъ е-нгъ
воля - во-ля, тэ-йелъ о-не
вонъ поди - тё-къ ва-нкъ
воображение - тэ-й
вообразить - тэ-йрбыгу
вооружаться - войнанъ гото-витчугу
вооружиться - тэ-гамъ и-гу
вопросить - со-гончигу
воръ - твэ-лъ, твы-олберъ
воробей - синдя-ка
воровать - твы-олгу
воровской - твы-олбыдимы
ворожить - чво-жиетыгу
воронъ - куля-
ворона - кво-ре
вороной - ка-регентъ
ворота - ма-да
воротить (кого) - могне- ба-ралгу
воротиться - могне- ба-ралгу
ворчать - кво-дымбыгу
воскресить - иле-етымбыгу
воспитать - оголчо-лджигу
возставать - ва-зыгу
возставить - ны-льджигу, че-тчигу
возстановлять - ва-тчигу
востокъ - чё-лындъ а-жармо
восторжествовать - нульдте-лдчигу, пра-здничугу
восточный - та-мынди
острый - нумера-нъ е-нгъ
восхищаться - путёмъ а-нталбыгу
вотъ - та-у
вотъ я тебе дамъ - ма-нъ те-гентъ ме-лебсъ
воткнуть (во что) - сы-кыгу
воткнуть (на что) - понджо-льджигу
воткнуть на палку - по-ндынъ понджо-льджигу
воцариться - а-мдикугле ме-гугу, а-мдикугле о-мдыгу, а-мдикугле о-мдальджигу
вошь - у-нычь
впереди - ня-нненъ
впредь - ня-нненгъ
врагъ - а-съ дру-къ
враждовать - а-съ дру-ганъ э-гу
врать - седе-птыгу
вредъ для здор[овья] - кё-зендимы
вредить, по[вредить] - вреди-мгу
вредный чел[овекъ] - во-риго-мъ
врожденно - те-лымб.
врозь - сытова-съ
всё - ве-сь, ве-сь е-нгъ
все равно - всё- равно-
всегда - ме-льдчь [зачеркнуто], завсегда-
всегда быть - завсегда- э-гу
вседелающий - ве-сьме-джерынди, ве-сьме-гумбыди
всемъ нравящшся - нра-винэ-стымбыди
вскочить - па-ктыргу
вскочить куда - вассе-дигу
вскочить со стула - па-ктыргу [ исправлено из па-ктымбыгу]
вследъ - о-кыръ ва-т<и>онъ
всплыть - ка-мбальджигу
вспотеть - нельдчигу-
вставить - мачко-льджигу
встать на моль - ча-вынъ чатымбыгу
встать о реке - канде-зимгу
встать съ пост[ели] - ва-зыгу
встретиться - ко-гычигу
всякш - ка-жнай
входъ - т́iунтъ се-ргу
вчера - те-лделъ
вшивый -у-нчирбанъ
въехать - ква-нгу
выбежать - тикуро-лгу
выбирать рыбу изъ сетей- ня-кыледа-дыргу
выблядокъ - тыбыга-тъ ко-мбыди
выбрасывать тяжесть - конне- ма-ктыгу
выбрать - выбира-имгу
выбросить - иллеча-жигу
выбросить на берегъ - конне- пальджо-льджигу
вывалиться - пы-кыльчигу
вывернуть - могне- ба-лгылгу
вывести - поне- ча-джигу
вывести вонъ - токва-ндыгу
вывести цыплятъ - ко-гу
выворотить - а-ублекатъ пи-гольджигу
вывострить - се-лгу
выгладить - гла-дингу
выгнать - поне- ка-ннингу
выдать - теми-гу
выдвинуть - точаго-льджигу
выдра - те-тъ
выехать - понеква-нгу
вызвать - квэ-ргу
вызваться [исправлено из вызвать чрезъ] - квэро-льджигу
выздороветь- сво- э-зембыгу
выиграть - и-гу
выйдти - поне- ча-джигу
выйдти за мужъ - те-быгу
выкидышъ - ку-мбыди те-лымбанъ
выколоть - мё-джежигу
выколупать - то-гатолгу
выкопать - па-катыгу
выкормить - а-бстугу
выкупивш|й - та-умкунди ко-мъ
выкупить - та-угу
вылезть - точа-нджигу
вылечить - э-стегу, легчи-мгу
вылить - ве-сь га-мджигу
выложить - и-нневентпе-нгу
вымазать - ма-зимгу
вымарать - ко-золгу
вымараться - ко-золчигу
вымерять глубину - ма-льджургу
вымести - чо-балгу
вымыть - мё-золгу
вымыть ружье - тю-льсэ сю-ннетмё-золчигу
вынуть - теи-гу
вынуть якорь - я-корь че-тчигу
выпадаетъ снегъ - сы-рымъ пе-нбатъ
выпасть - пы-кыльчигу, пы-нгылгу
выплыть - ка-мбальджигу
выплюнуть - свё-зыгу
выпросить - со-гончагу [зачеркнуто], ма-дыргу
выпрямить- та-дынкаро-льджигу
выпустить - ю-дыгу
выразить - ка-ткылгу
вырости - о-рынгу
выростить - о-ры<м>чигу
вырвать изъ зем[ли] - конджо-лтола-кчигу
вырваться - манчо-лгу
вырезать - ма-челгу
выронить - илле- а-съ тыгу
выручить - кундере-мъ и-гу
высекать ог[онь] - ва-скыргу
высидеть цыплятъ - ко-гу
высказать - ча-рыгу
выскочить - ча-рогу [исправлено //зча-рыгу]
выслать - тею-дыгу
выслужиться - угоди-мгу
высокш - пы-ръ е-нгъ
высокш чел[овекъ] - пы-ръ го-мъ
высота - пы-ргынъ е-нгъ
высохнуть - ча-гынбыгу
выставить - поне- мачко-льджигу
выстрелить руж[ьем] - папе-чжильгу
выстрогать - ко-дгаингу
высунуть - па-ргылбыгу
высушить - чаго-етыгу, ча-гынбыгу
вытаскивать сеть - ю-голгу
вытащить - ю-гулгу
вытащить лодку - конне- ю-гулгу
вытеребить - мизе-лгу
вытерпеть - терпи-мгу
выткнуть - пе-рельджигу
вытолкать-поненямбо-зигу
выточить - се-лгу выть
вет[ру] - э-чьжигу
выть волк[у] - кво-дынбыгу
выть чел[овеку] - чу-рогу
выхватить - ква-тчингу,
па-ктыле ча-быгу
выходъ - тГунтъ ча-нджигу
вычистить - нё-рбалгу
вычистить руж[ье] - сю-ннетъ нё-рбалгу
выше - пы-ргылагъ
вышн|й - нунсинче-гой
выяснеть - по-рабчимбыгу
вьюга - пу-рга, мерги- пальчо-
вьюга затихла - у-тыргу
вязать - свырме-нчигу
вязаться - вяза-тсанэ-зыгу
вянуть - иллепы-нголгу Г
галка - тыза-бала
гаснуть - ка-птымгу
гвоздь дер[евянный] - ти-бъ
гвоздь жел[езный] - гво-зильтибъ
где - ка-йгынъ, куте-нъ
где-нибудь - кудче-нь э-нейбы
гладкш - гла-дкш
глазъ - се-й
глина - чу-
глодать - ту-толеда-дыргу
глотать - а-мгу
глубина - ко-рынгь
глубокш - ко-рынъ е-нгь
глупость - глу-пасть
глупый человекъ - дура-гыненъ го-мъ, во-рыненъ го-мъ, тэ-йдъ ча-нгванъ го-мъ, глу-пай
глухарь пт[ица] - са-нгъ
глухой - котыди
глухой о звуке - сю-нчейбипужимы
глыбоватая земля - ка-нкаланъ е-нгъ
гнать, догонять - та-нгынбыгу
гнать въ погоню - ка-льджругу
гневъ - те-мба, сёндзене-й
во-дырсанъ [зачеркнуто]
гневъ бож1Й - Ну-нъ те-мба
гневаться - те-мбыгу, кво-дымбыгу
гнездо - пя-тъ
гниение - тэ-мбыдимы
гнилой - тэ-мбыди
гнилушка для курева - сырго-й по-
гниль дерева - тэ-мбыдимы
гнить - тэ-леча-жигу
гноевая рана - тэ-бырбанъ
гной - тэ-
гнусить - кё-ннембыгу
гнусный - аво-й го-мъ
гнуть - каро-льджигу
гнушаться - асъ свыо-ргу, токуро-лгу
говорить - че-нчигу
годъ - по-дъ
годы младенческ1е - кыба- э-зынъ
годы юношеск1е - куса-кынъ одчеде-й э-зынъ
голень - пулзе-й [зачеркнуто], ку-нгылъ
голова - о-лъ
головня - по-ндабъ
голодъ - а-вгалкъ
голодный - кво-затъ, аза-урбатъ
гололедица - го-лай ка-ндыкатъ, го-лай улго-
голосъ - го-лосъ
голосъ громкш - гро-мканго-лосъ
голосъ тоненькш - чо-зкинъ го-лосъ
голосъ толстый - ва-ргъ го-лосъ
голубь - го-лупъ
голый - го-лай, а-съ че-мбытбыди
гора - кэ', танба-ръ
горбатый - горбунъ
гордость, упрям[ство] - ва-ргыльчимбыди
гордость отъ богатс[тва] - ко-уранъ
гордый - чи-умбыди
горе - го-ря
горевать - таску йчигу
гореть - по-рымбыгу
гореть духомъ къ богу - кво-йунзе Но-мды кы-гугу
горечь - па-риндимы, го-речь
горло - со-й, куко-й
горница- ма-тъ-го-рниса
горностай - ку-ръ
городъ - ква-чь
городить - та-ттыгу
горсть - о-ра
гортань - куко-й
горшокъ - тюнака-
горькш - па-риндимы
горячш - пе-рчанъ
горячка болезнь - не-льдзигумбанъ
господинъ - няче-йгатъ,гаспади-нъ
господина жена - гаспади-ннэ-тъ
господствовать - гаспади-нанъ э-гу
господь - госпо-дь
гостить - гости-тчигу
гость - го-сть, чадзе-и го-мъ
готовиться - ква-нджигу
грабли - гра-бля
градъ - лага-й соронджо-нъ сейла-
грамотный - на-гырымты-ннымбыди
граница - ко-рымбыдимы
грачъ - ты-й кво-ре
гребень - те-псенъ
гребь (весло) - мо-голапъ
греметъ - ыэ-чьжигу
гр[еметъ] громко - ва-ргынь ыэ-чьжигу
грести весломъ - тукугу
грести гребью - мо-голапычигу
греть - пё-тчимбыгу
грива - пу-
гробъ - сэ -
грозить пальцемъ - му ннымпа-челгу
грозить слов[есно] - ы-эчьзе па-челбыгу
громъ - Но-мъ ё-дженъ
громкш - колосэ-
громко - о-рсе-е-нгъ
громко говорить - гро-мканъ че-нчигу
громко кричать - гро-мканъ ла-нгыску
громче - о-рселагь
грудь - кы-лынолъ
грудь женская - не-псытъ
грузъ - гру-зъ
грузный - татымбыле
грустить - таску-йчигу
грустно - таску-лянъ
грустный - а-нталгыди
грызть зуб[ами] - тутоледа-дыргу
грызть орехи - пуча-лгу
грязь - ны-ска, паска-
губа верхняя - инне-йтыу
губа нижняя - илле-йтыу
губитель - ко-мъ ке-ттеле ча-жикудъ
губить - катынбыгу
гудеше дудки - ыэ-чьжимбыдимы
гусли - гу-сли
густой - густо-й е-нгъ
гусь - тве-го
да - но-
давай, ну-ка - ча-, чатонъ
давать - ми-кугу, миту
давеча - ты-нъде
давно - кундо-кынъ э-зенъ
далек|й, дальн|й - кундо-кынъ е-нгъ
далеко - чу мбынъ
дальше - кундо-клагь
даръ душевный - душаги о-ромъ
даромъ - да-ромъ
дать - миту
дать въ долг - колча-ндмигу
дать знать - ве-стимъ ми-дыгу
дверная скоба - ма-данква-съ
дверной порогъ - ма-дандо-бъ
дверной створъ - ма-данко-ччеръ
дверь - ма-да
двигать - ча-гыргу, ю-голгу
двигаться - ча-голджигу, лаго-льдчигу
движимый - ю-голбыди
двоедушный - сы-дъ тэ-йде табынна-нъ е-нгъ
двойной - сыдню-рти
дворъ - воро-танъ сю-нчь
дворъ скотный - ворота-
двуязычный - сы-дымынды се-тчанъ
девица - одчеде-й кыба- не-йгомъ
девическ1Й, девич|й - де-пкагый
девка - де-пка
девочка - кыба- не-йгомъ
деготь - дё-гтиса-
дедъ - авна-ска
делатель - ме-мкунди
делать - ме-гу, ме-кугу, меледа-дыргу
делаться лучимъ - сво-нъ метугу
делаться темнымъ - лыба-нъ метугу
долить - та-ргу
дело - те-ланъ
день - те-лдъ
день (чрезъ) - тита-ви те-лдъ
день насталъ - Но-мъ те-лынба
деньги - ко-мде
деньги медн[ые] - меднай ко-мде
деньги сереб[ряные] - моне-танъ ко-мде
деревня - кыра-
дерево - ня-ргъ, по-
дер[ево] где подарки лозу - по-
дер[ево] гниет - тэ-леча-женъ
дер[ево] гнет ветеръ - ме-ркъ мы-ныкотъ
дер[ево] падаеть - пу-нгыллеча-женъ
дер[ево] падаетъ листъ - пы-нгыллеча-женъ
дер[ево] распускается - ча-быторыблеча-женъ
дерево растетъ - о-роблеча-женъ
дер[ево] сохнетъ - ча-нглеча-женъ
дер[ево] срубить - пача-лгу
дер[ево] увядаеть - те-гынъ ча-нджледа-дрытъ
дерево цвететъ - те-ллеча-женъ
держать, [держать]ся - ора-лбыгу
держать, иметь - ва-ргу
дерзать - насме-литчигу, сме-ланъ э-зыгу
десна - те-вуте, по-унъ тибито-у
дети - ийма-тлау
дети проклят1я - прокля-тай ийма-тла, прокля-тай приро-дъ
деточки - ийма-тламб|у
детскш - кыба-гой
детушки - ийма-тламб|у
дешевый - чо-сыванъ е-нгъ
дивный - ти-вай
ДИКие животныя - ма-тьинсу-рула
для (кого) - дат[ельный] падежъ
для меня - ме-генъ
для себя - пи-регантъ
дневной -те-лындъ
дно - ы-лдъ
до - на-уга (послб сущест[вительного])
до которыхъ поръ, докуда - ку-нчанъ
до о времени - ча-нъ (послб сущест[вительного])
до сего времени - та-у вре-мянчанъ
до техъ поръ - наса-кынъ э-зынъ
добежать - куро-лгу
добреньк1Й - сво-гула-ндъ
добро - сво-
доброделан1е - доброде-тель
добродетель - доброде-тель
добродетельный - сво-ми-кунди, доброде-тельнай
добрый человокъ - сво-гомъ
добыть зверя - ква-тку
довезти - ме-тергу
догадаться - ко-стыгу
догнать - ме-тыгу
догонять - та-нгынбыгу, кату
доехать - тюлеми-дымбыгу
дождаться - а-дыльчигу
дождь - со-ръ, соро-нгъ
дожидать - а-дыгу
доить - па-ргылгу
дойти - ме-тыгу
доказательство - доказа-тельства
доказывать - докази-мгу
долгъ - ко-лдча
долгъ - на-у, ка-й до-лжнанъ ме-гу
долгш - чу-мбынъ е-нгъ
долго - ку-ндынъ е-нгъ, ко-ндынгь
долговременный - ку-ндынвре-мяннай
долгоносый - чу-мбыпу-чиноли
долготерпеливый - ку-ндын<гъ> терпи-мбыди
должникъ - ко-лдчези ко-мъ
долина - ва-ргсо-й
доля, часть - ча-долъ
домъ - ма-тъ
домашнш - ма-ткый
домашнш скотъ - ма-ткыйсу-рула
домостроитель - ма-тынстро-имкунди ко-мъ
допрашивать - дапроси-мгу
допросъ - дапро-съ
дорога - ва-тъ
дорогой - мерсе-й е-нгъ
досадитель - досади-мкунди ко-мъ
досадить - досади-мгу
досадно - доса-днангъ
доска - ле-мъ
достать - и-гу
достигнуть - ме-тергу, ме-тигу
достигнуть - нынга- ми-дыгу, ми -дыгу
досугъ - досу-къ
досыта - ка-пучиле
доха - доха-
дочь - не-у
драгоценность - даргосе-ннанъ е-нгъ
драгоценный камень - даргосе-ннай ка-мень
дразнить - нея-льджимбыгу
драка - дра-ка
драться - дракыса-тчигу
драться - те-тенбыгу
древн1е грехи - и-ри гре-гла
древнш - и-ри
дремать - ко-ндольдже-нджигу [ исправлено из ко-ндолченчигу]
дробовикъ - дробови-къ
дробь - дро-пъ
дрова - палё-на
дровни - дро-венъ
дрожать - ты-ргымбыгу
другъ - дру-къ
другой - а-рымъ, а-внетъ, а-рынгь
дружелюбный - дру-жнанъ э-лыкунди
дружно - дру-къ, дру-жнанъ
дружными быть - дру-жнанъ э-зыгу
дуга - дуга-
дудить - са-нджиргу
дудка изъ тростника - ни-дерзучисанъ
дуло ружья - тюльсенпу-чь
дума - тэ-й
думать - тэ-йрбыгу
дунуть, дуть - пу-голгу
дуракъ - дура-къ
духъ - кво-йлъ [исправлено из кво-йолъ], кво-й, кво-йу
духовный - кво-йзиди
душа - душа-у
душистый - а-етезой
душить - сы-кдыгу
дымъ - кашко-у
дымить - кашко-льджигу
дыра - па-гыръ
дырявый - па-гырлазый
дышать - кво-яргу
дядя - елдча-у
дятелъ - чи-мдже
едва - насу-ль
едва едва не - е-рынъ а-съ, кыба-нъ а-съ
еденный - абледа-дыртымы
единодушно - окырмыдымъ э-мба, окырдуша-нтзе
елецъ - ква-нтъ
ель, ёлка - ню-лкъ
ёршъ - нырса-
если - е-сли
если бы - е-сликабы
естественный - приро-днай
естество - приро-дъ
есть - а-мгу
есть, обедать, ужинать - а-воргу
ехать - ча-джигу
ехать въ лодке - па-льдчигу
ехать вскачь - па-ктырнанъ ча-джигу
ехать рысью - га-зынъ ча-джигу
ехать шагомъ - кво-жинданъ ча-джигу
еще - та-ръ [зачеркнуто], а-й, а-йстъ
жадничать - ты-дымбыгу
жаждущш - ю-дыргу кыгы-нъ
жалить - па-кылгу
жалкш - жа-лкай е-нгъ
жало у змеи - у-готъ
жалоба - ты-бъ, кайно- о-мдтыбе
жалобно - омдле- ва-нба
жаловаться - о-мдытгу
жалеть - жале-имбыгу
жаль - жа-лка
жарить - жа-рингу
жаркш - пё-тпа
жарко - пё-тпанъ е-нгъ
жатва - жа-тва, абсо-т<ым>ма-чимбыдимы (<ьли>?)
жать, сжимать - ы-пкалгу
жать хлебъ - абсо-тима-ч<чи>гу
ждать - а-дольджигу [зачеркнуто], а-дыгу
жевать - ту-ттогу
желаше плотское - ва-тизиди кыгыде-
желан1е - кыгытэ-
желать - кы-гугу
железо - гво-зъ
желтый - па-дынъ е-нгъ
желчь - па-дъ
жена - пая-у, эмо-у
женатый - не-тымбыди
жениться - не-тыку
женихъ - жени-хъ
женск1я груди - не-псытъ
женск|й - не-йку-мъ
жердь - же-рде
жеребенокъ жен[ского полу] - сю-мака
жеребенокъ муж[ского полу] - ко-рока
жеребецъ - ко-ръ
жертва лозу - ко-за
жечь - пё-тчимбыгу
живительный - иле-етикодъ
живой - э-лынди
животь, брюхо - на-нчь
животъ (внутри) - си-димыдытъ
животворящш - иле-ети ку-жинди
животное - су-румъ
живущш - э-лыкунди
жидъ - жи -дъ
жидкой - зи-дкай енгъ
жизнь - э-лытетъ
жизнь хорошая - сво-элгу-
жизнь худая - а-вой элгу
жила - ки-унъ пе-нгъ
жилетка - камзо-лъ
жилище - э-лыанъ
жиръ - ё-ръ
жиръ рыбш - кво-лынъ ё-ръ
жиреть - ка-бырлеча-жигу
жирный - ю-рсей, ка-бырди
житель - наэ-тцигомъ
жить - э-лгу
жужжать - кы-нгырымбыгу
журавль - кара-
журчать [ручеек] - кю-мныгу, со-мнымбыгу
за водою - ё-тынно
за хлебомъ - ня-енно
за пищей - абсо-тинно
за столомъ - сто-лындакъ
за домомъ - ма-тындакъ
за дверью - ма-дандакъ
за все - ве-сь науга
за годъ - по-дында-кенъ	^
за день - те-лендакенъ
за месяцъ - эре-нда-кенъ I плата
за неделю - неде-ль да-кенъ )
за насъ - ме-чатъ, меча-дантъ, меча-догенъ
за это - на-мы-но-
забежать - тикуро-лгу
забеременеть о жив[отных] - инма-дыргу
заблудиться - ма-гыльчимбыгу, ё-ргугу
заборъ - забо-ръ
заботиться - забо-тимгу
заботливость - забо-та
забывчивый - ку-дъ ча-ст<а>нгъ а-вольджиннанъ
забыть - а-вольджигу
завалить (чемъ) - ка-йгу
завалиться (о скоте) - пы-нгылымбыгу
завернуться - поро-льджимбыгу
завернуть - поро-льджигу
завертка - завё-рка
завидовать - зави-димгу
завтра - карзе-нъ
завязать - са-ргу
завязить - манге-дигу
завязнуть - токва-тку
завянуть - илле- пы-нголгу
загадать загадку - ню-ргу, катку-
заглядеться - тимандже-чикугу, инне-нъ маннембыгу
загнать - ка-ннингу
загнуть - каро-льджигу
заговорить - че-нчилею-боргу
загореть лицо - мю-зыгу
загореться - поре-ндчигу
загородить - та-ттыгу, ора-нджигу
загородить, заставить - кондья-ргындымачко-льджигу
загородиться - ора-нджичигу
заготовить - запасчи-нгу
загребать землею - гадо-лгу, та-тку, пакылгу
задавить - че-лгынгу, сы-кдыгу
задавить (чемъ) - ча-нгыро-льджигу
задвинуть - чатольджигу
задница - тасе-нъ
заднш - могне-й
задняя нога - то-пъ
задуматься - тэйти-келеда-дыргу
задуть - путолгу
задушить - задуши-мгу
заехать - ке-дельджигу
зажать (ротъ) - ора-лгу
зажечь - по-рчигу
зажмуриться - се-ймга-йгу
зажужжать - кы-ныблею-боргу
зайдти - се-ргу
заклинать духа - кыча-тчигу
заключить куда - ке-ттыгу
заклясть себя - пи-ремтъ кыча-тчигу
заколоть ножомъ - па-зебе-релгу
законъ - зако-нъ
законодатель - зако-намъ ми-кудъ
закоулокъ - закау-локъ
закромъ - са-ккаръ
закружить - пю-ронгко-еетыгу
закружиться - пю-ронко-имбыгу
закружиться голова - о-лдогойва-птыгу
закуржеветь - ка-даумбыгу
залететь - тимбле-вангу
заливъ - со-йга
залить водою - ю-съ чага-мжлигу
заложить - пе-нгу
заложить между чего - а-рынгъ са-пе-нгу
заляпать - рока-льджигу
замаранный - ко-золомбыди
замарать - ко-золгу
замахнуться - утомлаго-льджигу
заменить одно другимъ - а-рымъ о-мдальджигу
замениться - о-мдальджигу
замесить - то-ктыгу
заметить - заме-тимгу
замириться - мириса-тчигу
замокъ - замо-къ
замокъ у ружья - за-кку
замолчать - че-нчилеутыргу
замочить - ёде-птегу
занавесить - ы-дыгу-
занавеска - за-навесъ
занимать место - ме-ста занима-имгу
заноза - а-думбатъ
занозить - а-думбыгу
занять - занима-ингу
занять денегъ - колча-ндъ и-гу
западъ - челчо-ндчь [зачеркнуто], те-лдъ о-мдырмандъ
западный - та-нгынди
западня - подпо-льма-да
запасный - запа-снай
запасти - запасчи-нгу
запахъ - а-етъ
запахъ гнилой - а-етиенъ
запахъ испражненш - тю-тиенъ
запахъ сладкш - ню-инди а-етъ
запереть - кё-ттегу, кё-ттембыгу
запертый - кё-ттембыди
запечатать - печа-таимгу
заплатать (пришить заплатку) - каби- ка-бигу
заплатить- ме-рчигу
заплатка - каби-
заплести косу - о-лымпа-тку
заплести ленту - ле-нтамъ са-ргу
запнуться - пы-кыльчигу, т<а>бо-лгу
запорошить снег[омъ] - кыба-нчо-мбыгу
запретить - о-дыргу, а-съ кура-льджигу
запрещать - а-съ кура-льджигу
запрягать, [запря]чь - таета-льджигу
запутать - пю-втугу
запутаться - пю-угу
запыжить - пы-жкамса-гелгу
запыхаться - кво-й<дам> мидыгу
зарезать - ма-тжегу
зарница, хлебозоръ - Но-мъ по-рымба
заронить искру - илле- э-стымбыгу, тю-йбо-рымбыгу
зарумяниться - сорзугу-мбыгу
заря - кыба-льчика че-нгу сю-льджеле ю-бырымба
зарядить ружье - а-бстугу
заселить - сели-нгу
заслонить - лудо-лджигу
засохнуть - ча-гынбыгу
засмотреться - и-нненма-ннембыгу
заставить - заста-вимгу
заставить, загородить - кондья-ргындымачько-льджигу
застать где - ква-тчингу
заступиться -та-лымбыгу
заступникъ - кудъ та-лымба
засунуть - пе-релгу
засыпать - ка-мджелгу
затаивать - та-умныгу
затворить - лудо-льджигу
затемъ - та-узе
затемъ что - на--но-
затемнить - лыба-нъ ме-гу
затихнуть - зю-льдзилеча-жигу
заткнуть - т<о>го-льджигу
зато - та-у-но-
затылокъ - сумба-
захлестнуть - ке-ттыгу
заходить солн[це] - та-гедимбыгу
зацепиться - ко-дальджигу
зачать во чреве - инма-дырле ю-быргу
зачаться о млад[енце] - инма-дырле ю-бырчигу
зачемъ - ка-йно-
зачесться - о-мдальджигу
зашить - сю-тку
защищать - та-нгымбыгу
заяцъ - нё-
званный - квы-арбыдимы
звать въ гости - квы-аргу
звöзда - кызга-нсе-й
[звöзда] утр[енняя] - каре кво-дди кызынга-нсей
[звöзда] вечер[няя] - ю-ди кво-дди кызынга-нсей
звöнöть - лае-етыгу
звöнитъ колоколъ - коура-къ- ыэ-чьжинъ
звöри - су-рула
звöрокъ - су-румби
звöрь - су-румъ
звонить въ кол[околъ] - мо-тку
звонкш - ля-ымбыдимы
звонко - ля-ымбыди е-нгъ
звукъ - му-зымбыдимы
звучать - музымбыгу
звучный - му-зымбыди
здöсь - ты-ндъ, тíунтъ
здороваться - чуло-мчигу
здравствуй - чуло-мъ
зöвнуть - а-бымбыгу
зеленая трава - па-дынъ ню-тчь
зеленöть - па-дынъ метугу
зеленый - па-дынъ
зелень - ню-тчь
земля - чво-чь
землякъ [вместо земля] - чу
земной -чво-чеги
зеркало - ма-нджерсанъ
зерно - а-рманзе-й
зерно овса - со-лу
зерно ржи - а-рзе
зерно ячм[еня] - а-рма
зигзагами, криво - пана-нъ ча-жемба, каро-камъ ча-жемба
зима - кэ-тъ
ЗИМН1Й - кэ-й
зимовать - кэ-ргу
злоба - аво-нэ-ппыдимы
злобствовать - авой тэ-йербыгу
злодöй - во-р<е> гомъ
злой - аво-й
злопомнеше - ста-рай аво-ймы тэ-йербындать
злословить - ты ту
злоумышлеше - аво-й тэ-й
змöиный - сю-нзиди
змöя - сю-
змöя водяная - ё-десю
знаше - ко-стымбыдимы
знать - ты-нногу
золотить - золоти-мгу
золото - золота
золото - альто-нъ [зачеркнуто]
золотой - золото-й, альто-ни [зачеркнуто]
зубъ - те- въ
зудить - кы-зынбыгу
зыбка - чо-бсъ
зябнуть - канде-зигу
зять - эмне-у

и - а-й
ива - ту-льджре
иголка - мыга-
игольникъ - мыга-нчо-лкъ
игольныя уши - пютъ
играть - ва-ркыгу, са-нджиргу
играть на балалайкö - ке-ттелбыгу
играть на гармоникö - н<и->гырчигу
играть на дудкö - са-н джиргу
играть на скрипкö - на-ндчигу
идти - ча-джигу
идти впереди - уко-нъ ча-джигу
идти по слöдамъ - вато-унтча-жигу [ исправлено из вато-унтча-джигу]
изъ - до- (после существительного])
изъ всего видно - се-ланъ- а-донъ
изъ которой - ка-ймыгынъ
[зачеркнуто]
изъ тöхъ людей - на-гуландо
изъ усердiя - седе-гундъ
избавить - парани-лгу, изба-вимгу
избавиться - парани-лчигу, изба-витчигу
избöгать, остерегаться - токе-скугу
избöгать, убöгать - токуро-лгу
избранный - выбира-имбыди
избрать - выбира-имгу
избыточествовать - ли-шнанъ э-зыгу
извертöть - па-кылгу
извöстить - ве-стимъ ю-дыгу [исправлено из вепстимъ миОдыгу]
извöстный - изве-снай, знако-май
изгрызенный - туто-лбыдимы
изгрызть - туто-лбыгу
издавать звукъ - ку торгу
издалека звучать - му-зымбыгу
издали - кундо-кындо
изъ-за - до-гуванъ (после сущ[ествительного])
[изъ-за] двери - ма-дандо-гуванъ
[изъ-за] дома - ма-ткындо-гуванъ
[изъ-за] стола- сто-ландо-гуванъ
излишекъ - ли-шнанъ э-зыгу
изломанный - пана-лбыди
изломать(ся) - пана-лгу
измениться - а-съ ны-льди ме-гугу
измятый - пё-ктылбыди
измять - пё-ктылгу
изнанка - а-съ ва-ндъ
изнемогать - а-лконме-гугу
изношенный, вöтхiй - лакча-нби
изорванный, вöтхiй - лакча-нби
изорваться - нычькыльджигу
изъ подъ - ыло-нды, ыло-гынды (после существительного])
[изъ подъ] дерева - поныло-нды
[изъ подъ] дома - ма-тыныло-нды
[изъ подъ] подполья - подпо-лылогынды
[изъ подъ] стола - столыло-гынды
израненный - панпе-релбыди
изрубить - пача-лгу
изукрасить - краси-ванъ ме-гу
изъöдать - а-мгу
изъöденный - а-мбыдимы

икона - Но-мъ
икра ноги - про-чь
икра рыбья - ты-рымъ
или - а-ли
имöть попеченiе - забо-тимгу
имя - не-мъ
иначе - тэдатаръ
иначе сказать - тедата-ръ катку-
иней - ка-дамба пы-нгылымынды
иногда - ка-йгнемеле-
искать - пе-гу, пе-гылгу, пе-рынджигу
искра - тю-й
искриться (снöгъ) - чу-льджеле ча-жигу, чу-дыледадыргу
искусникъ - ма-стеръ
искусный - ки-тырнанъ
искушать - искуси-мгу
искушенiе - искуше-нья
исповöдать - пове-даимгу
исповöдаться - нё-рбалгу
исподки - испо-дка
исполнитель - ку-дъ ме-мбанъ, ме-кудъ
исполнить - ме-гу
испортить - испо-ртимгу
исправить - пра-вимгу
исправиться - сво-нъ э-зыгу
испугаться - кы-чьватгу
испытай - ма-ннембетъ ква-ллебе
испытать - про-баи мгу, пыта-имгу
изслöдовать - ма-стерынъ ко-стыгу
изсушить - ча-гыргу, чаго-етыгу
истратить - тра-тимгу, тра-тиледа-дыргу
истребить - мизе-лгу
иступить - кыа-нъ э-стыгу
иступленный - кыа-нэ-стымбыди
изчезнуть - ё-ргу
къ (чему) - до-ты
[къ] водö - ё-тындоты
[къ] дорогö - ва-тындоты
[къ] рöкö - ква-йендоты
къ тому - на-мынтъ
коблукъ у ноги - сын га-
кадило - кади-ланъ
кадить - кади-ланкю-ргу
кадочка - ка-чка
каждый - ка-жнай
кажется - ка-жеца
какъ - кунда-ръ
какъ будто - калака-й
как-нибудь - кунда-ръ емъ
какой - кунда-ръ еди-
какой-нибудь - ка-ем и
какой то - ко-дъ-та-
какой то особый - ко-дъ та а-рымъ
калина дер[ево] - кали-на по-
калить - ча-дыгу
калымъ за невöсту - калы-мъ
камень - пю-ллага
камень драгоцöнный - драгосе-ннай ка-менъ
канатъ - кудго-
канатъ толстый - ча-рымъ кудго-
кандалы ножные - топоти кандалы-
кандалы ручные - уто-ги кандалы-
капать - ча-пымбыгу
капать о водö - са-гамбыгу
капканъ - се-п кой га-пка
капля - ка-пелька
капсуль ружья - ка-псонъ
карась - тудо-
карiй - ка-ряй
катать колесомъ - пю-нглеетымбыгу, пю-ронгъ ко-ирыгу
катать круглое - пю-нгульджигу
кататься въ салаз[кахъ] - ю-гулбыгу
кататься на лош[ади] - гуля-йчигу
кататься съ горы - не-сыргу
катиться (лежа) - пю-ронко-ирыгу
катиться шаромъ - пюн-гольджильжигу
качать - ко-гургу
качать головою - о-ломъ ла-гыргу
качать ребенка - ку-гургу
качаться на качеляхъ - ку-гургужи<гу>
качели - казла-
кашлять - котку-
каяться - ка-имбыгу
квашня - ня-ика-чка
къ верху - котте-
кедръ - те-тынгъ
кедровая шишка - сва-нгынъ о-лъ
кивать головой - о-лондъ мы-нджиргу
кидаться (собака) - па-ктыргу
кипöть - пе-рчигу
кирпичь - кырбы-чь
кислое молоко - ча-псенъ молоко
кислый - ки-слай е-нгъ
кишки - кё-дла
кладбища - каги-тъ
кланяться - о-мдалгу
кланяться до земли - о-мдалгугу
класть - пе-нгу
клевать - па-читыгу
клевета - та-гола аво-нъ че-нчимбыди
клеветать - та-гола ав<о-й> че-нчигу, ча-рыгу
клеветникъ - та-гола ча-рымбыди ко-мъ
клеи рыбiй - чи-въ
клепцы (ловушка) - ча-косъ
клюка - клюка-
ключь, ручей - со-й
ключь замочный - кле-зенгво-зъ
клясться - не-вончигу
клятва - не-вончимбыдимы-
книжное слово - книжнай ыэ-чь
книжный - кни-жнай
кнутъ - ка-рсынъ
князь - князь
кобыла - сю-мъ
коварство - а-лымбыдимы
ковать - кова-ингу
ковшъ - кво-зкала-
ковырять - па-гатыгу
когда - куса-кынъ
когда-нибудь - куса-кынъ е-мъ
коготь - ка-тъ
кожа - ко-пъ
кожа выдöланная - чу-гунко-пъ
кожа животнаго - ко-пъ
кожаный - ко-жанай
колъ - ко-лъ
колдунъ - ккэ-тцыенгъ
колебаться - ни-льдингъ тэ-йербыгуай нанде-ръ тэ-йербыгу
колöно - пулзе-й
колесо - колесо-
колода - по-лдобъ
колодникъ - чурме-гамъ а-мнымбыди ко-мъ
колоколъ - коура-къ
колонокъ - колоно-къ
колотить - ке-ттелбыгу
колоть - чо-калгу
колупать - то-гадолгу
колчанъ для стрöлъ - пура
колыхаться - ти-клымбыгу
кольцо - пю-ръ
кольчуга - кво-зи ка-поргъ
комаръ - не-нка
комната - ма-дансюнчь
конецъ - та-бытъ, ко-нчь
конецъ беремöнности - инма-дырле ко-нчь
кончить - ма-льчугу
копать - ко-патыгу
копить деньги - ко-мде та-келеда-дыргу
копыто - салла-къ
кора - по-нка-съ
корень - по-нко-нджь корень
пузырь - мерсе-йпо
корка - ка-стъ
кормъ - а-бсотъ
корма лодки - а-ндынтасе-нъ
кормить - а-бстгу
кормить грудью - не-псензе не-ургу [исправлено из не-псензе у-румгу]
кормить реб[енка] рожкомъ - у-румгу, не-ургу [зачеркнуто]
кормовое весло - кормо-вой ла-пъ
кормовщикъ - а-ндентасе-нди ко-мъ
кормчiй - кормово-й ко-мъ, а-ндентасе-нди ко-мъ
корова - сы-ръ
короткiй - ка-вканъ
кортомъ - ко-ртъ
кортомъ заплатить - ко-ртъ ме-рчигу
корчить - мутальчигу
коршунъ - э-ттча
корысть, прибыль - коры-съ
корыто бел[ьевое] - коры-то
корыто (для рыбы) - чангнэ-
корыто мал[енькое] - чангнэ-ка
корь съöла - чо-къ <а->мбатъ
коса на берегу - каса-, чо-ръ
коса песчаная въ рöкö - каро-чь
косить - па-четыгу
косматый - ле-йбайо-ли
косой - косо-й
косоплетка - незо-
кость - лы-
костяной - лы-й
косынка - косы-нка
косякъ двери - коло-да мада-нъ
косякъ окна - коло-да око-сконъ
котелъ - кво-зильди
который - кудъ, ко-дъ
который слушаеть - ю-нгольчимбыди
кочка болотная - ка-льджно-лъ
кошка - ко-шка
кошма - нё-й
краденый - твы-олбыдимы
край - кра-й, до-бъ
крайнiй - кра-йгеи, <те-га тига- тебе-комъ> [зачеркнуто]
крапать (дождикъ) - васке-птыгу
крапива - са-тчь
красавецъ - те-га тига- тебе-комъ
красавица - не-йгомъ, во-тъу-жъ сво-енгъ
кроткiй - чё-нджика го-мъ
крошка хлöба - сыка-
крошить - ма-челгу
круглый - пю-рое-нгъ
кругомъ виноватъ - ку-ргомъ винова-танъ е-нгъ
кругомъ ходить - ко-ирыгу
кружить - ко-ирыгу
крупный - кру-пнай е-нгъ
крутой - ма-ченъ е-нгъ
крыло - ту-тъ, каро-чь
крыльцо - кры-ниса
крюкъ деревянный - кода-
крючкомъ - кода-канъ е-нгъ
крючекъ желöзный - кэ-теръ
крючекъ у зыбки - пы-нгырса-нъ
крякать, кряхтöть - ча-гыгу
кто-то - ко-дъ та
кувыркаться - па-рынмачко-льджигу
куда - куте-нъ, ку-
куда-нибудь - ку-емъ, куэмеле-, кудте-темъ
кудрявый - кудря-вай
кукла - нэ-ка
кукушка - са-гвя
кулакъ - кло-ка
куликъ - со-съ
куликъ долгохвостый - санджо-ка
кумъ, кума - кума-, куманё-къ
купаться - у-ргу
купить - та-угу
куржевень - ка-даумба
курить - ня-кылгу
курить чöмъ,
под[курить] - кашко-льджигу
куриться - кашко-йбыгу
курица - ку-риса
курносый - курно-скай
курокъ ружья - тю-льсенса-кку
куропатка - у
курья - ку-ссере
кусаться, [куса]ть - о-ттагу
кусокъ - кусо-ка
кустарникъ - су-нгъ, со-ггы
кушанья - а-бсотъ
лавка, скамья - ла-кунъ
ладонь - ча-ндчьпе-ка
лазить - сы-голгу
ласка звöрокъ - ла-ска
ласкать - твэ-дылбыгу
ласковый чел[овöкъ] - сво-гомъ
ласточка - квеге-лька
лаять - му-дыгу
лгать - седе-етыгу, сизя-ктымбыгу
лебедь - чи-нгъ
лöвая рука - кво-дте уть
лöвая стор[она] матерiи - а-съ ва-ндъ
легкiй - са-пка е-нгъ
ледъ - улго-
ледъ ломаетъ - улго- питколледа-дрытъ
ледъ набросало - улго- коннекы-лбатъ
ледяной - улго-й
лежать - э-пегу
лежать безъ памяти - э-пегу а-съ ты-нногу
лöкарь - ле-карь
лöлöять - не-жарольджимбыгу
лöнивый - а-съ кы-гынди го-мъ
лöнь - ле-нь
лепешка - лепё-шка
лöпить - ня-гантъ па-рчигу
лöсъ - ня-ргса-нъ
лöсъ, тайга - ма-ть
лöстница - сы-рсапо-
лота, годы - по-дъ
летать - ти-мбыгу
лöтнiй - ё-ти
лöто - та-ыдъ
лöтовать - та-ыргу
летучая мышь - ко-тынгъ
лöчиться - легчи-тчигу
лжепророкъ - а-лынкунди проро-къ
лжеучитель - а-лынкунди учи -тель
лизать - нютылгу
лизнуть - ню-голгу
линь рыба - ка-вья
линючiй - чарзо-димы
линять о живот[номъ] - пучва-леча-жигу
линять о матерiи - ча-ргу
лисица - лога-
лиственница - ти-у
листъ - ня-ргынча-бъ
листъ отпалъ - топы-кыльчимба
лисья нора - о-рто
лить - га-мджигу
лить изъ свинца - га-мджигу
лихорадка - су-зря
лице - ва-ндъ
лице матерiи - ва-ндъ
лишенный - на-гомъ, кудынна-нъ ора-лле и-мбатъ
лишиться - ё-ргу, ё-рчигу, реши-тчигу
лишнiй - л-ишн<а>й
лишь только - э-рынгъ
лобъ - ча-ндчьга-нъ
лобзанiе - ни-дымбыдимы
лобзать - ни-дгу, <ч>око-льджигу
ловить - пенджигу
ловить рыбу удочкою - мисчо-лгу
ловушка - лаву-ска
логъ - со-й
лодка - а-нда
ложа ружья - тю-льсемпо-
ложиться - эпенджигу
ложиться спать - э-пегу ко-ндыгу
ложка - сола-нъ
ложный - а-съ справедливанъ е-нь, а-лынкунди
ложь - асъ правда
локоть - сы-нчелъ
лопата - лопа-та
лопнуть - пассе-дигу
лоскутокъ - лоскутка-
лосниться - по-ромбыгу
лось - пе-нкъ
лошадь - кю-нтъ
лубокъ - ду-бъ
лугъ - ню-ртъ
лужа - Но-мъ со-рымба, ю-тъ капсе-димба
лукъ для лисицы - ындэ-
лукъ для стрöлы - ы-ндъ
лукавый челов[öкъ] - мо-лади го-мъ
лучь - кызга-
лучина - лучи-на
лучистый - кызга-й
лучше - лу-ччилагъ
лучшiй - лу-ччи
лыжи - то-льчь
лынтаи (обувь) - лынта-й
льдина - сырле-мъ
льстивыя слова - а-лынкунди ыэ-чьла, сизя-ктымбыди ыэ-чьла
льстить - седе-птыгу
любезный - свыо-рынди, любе-знай
любезны[я] дöти - любе-знай ийма-тла
любимый - сво-рынди
любить - свы-аргу
любовница - любо-вниса
любопытный - любопы-тный
любящiй - сво-ркунди
лягать, [лягать]ся - та-птыгу
лягушка - ча-мджъ
ляшки - лё-кылы
мазать - ма-зингу
макать - та-кугу
маленькiй - кыба-енгъ, кы-бальчига
маленько - кве-нъ
малина - синдя-канъ а-бсотъ
мало - та-нака е-нгъ
малорослый - а-съ пы-ръ го-мъ
мальчикъ - кыба- го-мъ
манить - кво-ргу, мани-нгу
манить рукой - утомъ ла-гыргу
марать, [марать]ся - ко-золгу
масло - ма-сло
масляный - ма-сланъ ма-зимбатъ
мастеръ - ма-стеръ
матернiй - а-утди
матка въ потолкö - по-рсъ
матушка - а-ва
мать - э-велъ
махать - ла-гыргу
махнуть рукой - утонъ ла-гыргу
маяться - маиса-тчигу
маячить рукой - утонъ ла-гыргу
медвöдь - кво-рокъ, су-румъ
медленно - чё-ндженгъ
медленный челов[öкъ] - чё-ндженъ ме-кунди
медлить - чё-нджигу
мöдный - тула-й
мöдь - ту-ла
между - кечё-льдчь
между (разстоянiе) - сы-дыго-детъ
между собою - о-ндзенягынъ
мелкiй - ме-лкай е-нгъ
мель на водö - ча-въ
мöнять - та-ргу
мерзлый - ка-ннымбыди
мöрка ружья - ме-рка
мерлушка - мерлушка
мертвый - ку-мбыди
мöру встрясти - лагеетыгу
мöру надавить - илле-тигылгу
мöру насыпать - тiерлега-мджигу
мöру насыпать съ верхомъ - верхынъ га-мджигу
мöрять - ма-нджигу
мöсить - то-ктыгу
мöсти - чо-балгу
мöсто - место, чво-чь
мöсто сухое - чво-чь ча-гымба
мöсто сырое - чво-чь ё-доумба
месть - аво-ймымъ ме-рчимбыдимы
мöсяцъ - э-ретъ
мöтать сöно - мя-ктылгу
мятель - пурга, бура-нъ
мöтла - чо-па
мöхъ - ме-къ
моховой - ме-ксуй
мöшать (что) - то-ктугу, меса-имгу
мöшать чöмъ - ны-нгольджигу
мöшокъ - коча-
мöшочекъ для дроби - дро-бикоча-
мигать - се-ймы-рыргу
милосердый - ми-лостиванъ е-нгъ седе-узе
милостивый - ми-лостиванъ
милостыню подать - ма-дыре ко-мде ми-гу, ми-лостынямъ ми-гу
милостыню просить - Ну-мды ма-дыргу
милостыня - ми-лостыня
милость - ми-лость
милый челов[öкъ] - сво-чьга го-мъ
мириться - мириса-тчигу
младенецъ жен[ского полу] - не-йгомъ
младенецъ муж[ского полу] - тебетомъ
младенецъ общ[ее названiе] - са-дыка кыба- го-мъ
младшiй - кыба-енгъ
много - ко-чиенгъ, тэ-игда
многомилостивый - ко-чи ми-лостивай
многообразный,
многоразличный - ко-чи ра-знай
многоцöнный - путё-мъ мерсе-й
множество - тэ-йгалкъ е-нгъ,
ко-чи
могила, яма - кы-лъ
могила засыпанная - каги-тъ, кага-й ма-кка
мозгъ - ке-ювъ [исправлено из ке-юввъ]
мозгъ въ костяхъ - лы-ди ке-ювъ
мозгъ головной - о-лынъ ке-ювъ [исправлено из ке-юввъ]
мокрый - ю-думбыди
моксунъ (рыба) - ко-ръ
молвить - ыэ-чьжигу
молиться Богу - Но-мтъ о-мтыгу
молнiя - Но-мъ те-лырнанъ
молодая дöвица - одчеде-й кыба- не-й гомъ, де-пка
молодая женщ[ина] - одчеде-й не-й го-мъ
молодой челов[öкъ] - одчеде-й го-мъ
молоко - молоко-, не-пса
молоко матернее - а-утди не-пса
молотить хлöбъ - молоти-тчигу
молоть - на-дыргу
молчаливый - кю-гальджиле свыо-ркунди
молчать - кюга-нъ енгу, кюга-льджигу
моргать - мыре-тчинбыгу
морда для рыбы - ка-ръ

морда (челов[öку] въ морду) - вандо-унтъ
море - мо-ре
морозъ - те-ссунгъ
морозная ночь - ка-рымбатъ пе-нъ
морошка ягода - пал го-
морской - мо-реги
мостъ - мо-стъ
мостить - мо-стычингу
мотылекъ - ла-мерека
мохъ - чу-мбъ
мохнатый - пы-рлай
мочить - ёде-птегу
мочь, могу - могу-, мо-жетъ
мошка - сыба-рго
мстить - ава-йзе могне- ми-гу
мужъ - эра-у, тебе-у
мужъ (въ лöтахъ) - те-бынче-нжи го-мъ
мужеложствовать - тебе-кум- ма-тку
мужескiй - тебе-ку-мъ
мужикъ - тебе-гомъ
мука - мука
мука (хлöбная) - мо-ка
муравей - кыча-
муравейникъ - кыча-й ма-кка
мускулъ - че-нъ
муха - чибе-
мучить - мучимбыгу
мучиться - мучиса-тчигу
мылить - мылазена-тку-льджигу
мыло - мы-ла
мыслить - тэ-йрбыгу
мысль - тэ-й
мыть, стирать - мю-золдчикучигу
мыть руку - уто-нъ мё-золдчигу
мыться - мё-золдчигу
мычать - па-ркугу
мышеловка - чан го-
мышца - календа-бъ
мышь - та-ва
мягкiй - пуда-канъ е-нгъ, нипсыка-нъ е-нгъ
мязга древесная - ко-пытъ
мякишъ хлöбный - пу-читъ



мясной - ва-ти
мясо, тöло - ва-ть, кё-дынва-ть
мятежъ - бу-нтъ
мять - пе-ктылгу
на него - табни
на нихъ - таблани
на свои деньги - о-нендъ ко-мнензе
на цыпочкахъ - чи-гальчика
набить - саке-ллепе-нгу
набожный челов[öкъ] - Но-мтъ о-мтымбыди ко-мъ
набокъ - кё-нъ
набросать - кы-лгу
навöрное - наве-рна
навернуться (о слезö) - се-йндгойча-нныгу
навести (что) - наведи-мгу
навöтъ - та-гола аво-нъ че-нчимбыди
навöтовать - та тола аво-нъ че-нчигу
навлечь - менде-лгу
навозъ - саба-нъ
нагишомъ - нельде-нкопи
нагнуться - муга-льдчигу
нагой - а-съ че-мбытбыди
наголовникъ - олыза-ри
надежда - наде-жда
надöть - се-ргу
надöяться - наде-ямбыгу
надзиратель - ма-ннемкунди ко-мъ
надзирать - ма-ннембыгу
надмöваться - ва-ргыльджигу
надобно - на-добнанъ е-нгъ
надоöдать, надоöсть - наску-чимгу
надолго - ку-ндунъ
надолго достанетъ - ку-ндынгъ- меде-нчитъ
надсматривать - ма-ннембыгу
надсмотрщикъ - ма-ннемкунди ко-мъ
надуваться, натужиться - крепи-мбыгу
наединö - о-кырзе, сы-дъягъ
наживать - нажива-йчигу

назадъ - могне-
назадъ отдать - могне- ми ту
назвать - не-мбыгу [исправлено из не-мнембыгу]
назначить - назна-чимгу
называться - не-мнембыгу
найдти - коту
найдтись - ко-гымбыгу
наказанiе - наказа-нья
наказать - накази-мгу
наканунö - те-лдзелъ
накидать больш[ую] кучу - ва-ргынъ пы-ргынъ тел ь джигу
накипöль - сы-рбанъ
наклонить - о-мдальджигу
наклониться - муга-льдчигу
наконецъ - нынблэ-
налимъ - ню-
налить - га-мджигу, тiерлега-мджигу
наложить - пе-нгу
намостить - мо-стычингу
нанизывать - со-нгургу, че-тчигу
нанять - ле-йдыгу
наняться - лейде-нчигу
нападенiе грöха - искуше-нья
напасть, бöда - беда-
напасть, [напа]дать - напади-нгу, па-ктыргу
напасть на шею - нуко-унтъ ка-валгу
написать - на-гыргу
напиться - ю-дырчигу
наплавокъ - ка-зъ
напоить - юто-льджигу
наполнить - тiерлембыгу
наполниться - тiерлебчимбыгу
напомнить - табни- тэ-йербыгу
направить - на- вато-унтъ ква-ндыгу, напра-вимгу
направить дорогу - вато-нтъ пра-вимгу
направиться идти - вато-нтъ пра-вильджигу
напрасно - та-гола
народился мöсяцъ - эре-тъ са-ндери те-лымбанъ
нарочно - наро-шнанъ е-нгъ
нарта - ка-нджь

нарядиться - наряди-мгу
насадить - о-мдальджигу
насилованiе - пана-лбыдимы
насиловать - си-ла<мъ> ора-лгу, пана-лгу
насилу - насу-ль
наслаждаться - ню-инди э-лгу, сла-дканъ а-ворле
наслöдовать - насле-димгу
наслöдство - насле-детва
насмöхаться - пе-скугу
насмöшки - писку-мъ
настъ по снегу - ка-нтъ, к<о->мъ ва-тчимба
настлать - чаты нгу
настоящiй - тида-мди, тамбо-й
настращать - ла-рчимбыгу
настроить (инстр[ументъ]) - ня-кыльджи пра-вимгу
настроить (подъучить) - о-дальджигу, оголчо-лджигу
наступить (на что) - те-гальдчигу
насупротивъ - кё-йгондъ
насыпать - га-мджигу
насытиться - ка-пучигу
науськать - о-дальджигу
научить - оголчо-лджигу
нахмуриться - ва-ндымъ пирса-льджигу
находить (о тучö) - ва-зилечажигу
находиться - эту
находка - ко-мбыдимы
начало - у-гутъ
начальствовать - нача-льникангле эгу, ме-гугу
начатокъ плодовъ - пе-рвай чо-бырла
начать - ю-бы ргу

начаться - ю-бырчигу [исправлено из ю-бырличигу]
начерпать - камдже-лгу
не - а-съ, ы-къ, этыстъ
не во снö а наяву - ко-нджиргу
невозбранять - а-съ а-съ кура-льджигу
не давать - а-съ ми-кугу
не заботиться - а-съ забо-тимгу
не забудь - ы-къ а-вольджетъ
не забыть - а-съ а-вольджигу
не запрöщать - а-съ а-съ кура-льджигу
не зöвай - сытоне-нней ы-къ ма-нджельбакъ
неладится - ла-дица а-съ э-зыкванъ
не любить - а-съ свы-аргу
необидливый - на-гомъ ника-къ сорди-танъ а-съ эсте-нджинъ
необинуясь - та-умнымбыгунджалтъ
необманчивый - а-съ а-лымбыди, а-съ сизя-ктымбыди
неоднажды - а-съ о-кырынгъ
неперестающiй - а-съ у-тырымбыди
непопасть въ цöль - ы-къ чарку
непослушаться - а-съ ю-нгольджигу [исправлено из а-съ ю-нгольджигугу]
непоходить - а-съ ня-мди пю-тти э-зыгу
нераскаянный - а-съ ка-итса-й го-мъ
нескверный - а-съ скве-рнанъ е-нгъ
нескрывая - та-умнымбыгунджалтъ
не смöй - ы-къ миттембе-тъ
несмертельный - а-съ куссо-ди
несмочь - ла-рымбыле ме-гу, а-съ насме-литчигу
несогласиться - а-съ кы-гыгу
неспать, бодрствовать - пё-тыгу
нестараться - а-съ стара-йчигу
не такъ - а-съ нильдингъ
не татары ли - а-съ ты-ла ли
неторопиться - чё-нджигу, а-съ ты-дыгу а-съ кы-гугу нунси-нчегой,
неуспокоенъ - ме-мба о-мделе а-съ ма-льчимба
неутаиваться - а-съ та-умтыгу
нехватило (чего) - а-съ меде-нбанъ
нехотöть - а-съ кы-гугу
небесный - но-мгеи
небо - ну-нъ си-нчь
небо во рту - кы-нгыръ
небрежность - а-съ стара-нья
небречь - а-съ стара-йчигу
невöжество - а-съ ко-стымбыдимы
невöрiе - а-съ ве-ра
невöста - неве-ста
невинно - та-гола
неводъ - ляво-да
невозбранно - ку-дынъ нэ-й а-съ меса-имба
неволя - а-съ во-ленъ
невыразимый - сво-мы тако-й сказа-ть нельзя-
негодованiе - те-мба
недавно - а-съ ку-ндыкванъ
недоносокъ мл[аденецъ] - ку-мбыди те-лымба
недостаетъ - а-съ ми-тукванъ
недоступный - поступи-нэ-зыгу нельзя-, кэ-гентъ ква-нгу нельзя-
недосугъ - недосу-къ
недоумöвать - а-съ ты-нногу, ка-й тэ-йербыгу
нежели прежде - уко-нъ на-умы кунда-ръ
нездöшнiй - а-съ ты-нди
незлобивый - ку-дъ аво-ймы а-съ меледадырытъ
незнанiе - а-съ ко-стымбыдимы
неизвöстный - а-съ изве-снай, а-съ знако-май
некогда - недосу-къ эва-нъ
некрасивый - а-съ сво-
некуда - куте-тгатъ
некуда дöваться - куте-тъ каде-н джигу
нелинючiй - а-съ чарзо-димы
нельзя - а-съ мо-жна, нельзя-
нельзя - аво-й э-ванъ, э-зынъ, э-нчитъ
нельма (рыба) - ва-нчь
немало - а-съ та-нака, а-съ ко-чинъ (иногда говорятъ)
немного - а-съ ко-чи
немного погодя - э-ттангъ э-лебе
нöмой - се-гда, се-галкъ
немощный - мессалай, а-лкой
ненавидöть - ка-ндыбынгъ а-съ свы-аргу
ненависть - ка-ндыбынгъ а-съ свы-арындимы
ненадолго - а-съ ку-нтъ
ненастье - лыско-тъ
ненастье - Но-мъ ке-тынба
ненастье продолжительное - во-деренъ ке-тынба
неокончанный - а-съ ма-льчимбыди
неплодiе - а-съ ко-кунбыдимы
неплодная женщина - инма-дымъ а-съ ко-кудъ
непорочный - поро-кангалкъ
неправда - а-съ пра-вда
неправду говорить - седе-птыгу
неправедная мзда - а-съ справедли-вай пла-тъ
нерадöнiе - ле-нь, а-съ забо-та
нерадöть - а-съ забо-тимгу

неразумный - тэ-йгыди
несказанный - катку а-съ мо-жнанъ е-нгъ
нöсколько - куса-йесъ
несправедливая плата - а-съ справедли-вай пла-тъ
несправедливо - а-съ справедли-вангъ
нестроенiе (инструмента]) - а-съ ня-кыльджи
нöтъ - ча-нгванъ [исправлено из ча-нго]
нöтъ разницы - ра-знисамъ ча-нгванъ
нетерпöливый - а-съ терпи-мбыдимы, терпи-мгыди
неувядаемый - а-съ пы-нгылко-унь
неукротимый - табни-сми-рнанъ ме-гу аво-й е-нгъ
неужели - аразе-
неусыпно - путё-мъ
неутвержденный - а-съ утверди -мбыди
нечаянно - неча-янна
нечего - не-чего
нечестный - ненаде-жнанъ го-мъ
нечистота - а-съ чи-станъ е-нгъ
ни за что - да-ромъ
нигдö не - ко-съ ка-йгынъ нэ-й а-съ
ниже - ла-мдылагъ
нижнiй - чво-ченба-рымъ
низать бисеръ - со-нгургу, че-тчигу
низенькiй - ла-мдыкала-н(ен)гь
низкiй - ла-мдыка е-нгь
низлагать, низложить - нянпа-рытъ илле-й пе-нгу
никакой челов[öкъ] - ко-съ ка-й го-мъ нэ- а-съ
никогда - куса-кынъ нэ-асъ
никого не - ко-съ ку-дымъ нэ-й а-съ
никому не - ко-съ ку-дыни нэ-й а-съ
никто - ко-съ ка-й нэ-асъ
нитка - сеть
ничего, ничто - ка-й не-й
ничего нестоющiй - ка-йда а-съ сто-имбыди
ничтожный - ка-йда а-съ сто-имбыди
нищiй - ни-щiй эра-
новорожденный - а-съ кундо-кынъ те-лымба
новый - се-нтъ е-нгъ
нога - то-пъ
нога задняя [у] жив[отного] - то-пъ
нога передняя [у] жив[отного] - у-тъ
ноготь - ка-тъ
ножикъ - па-
ножницы - сы-донепа- [ исправлено из сы-дыпа-]
ножны - па-ндзанъ
ноздря - пучино-лсе-нчь
нора лисья - орто-
носъ - пучино-лъ, пучь
носъ у лодки - а-ндыно-лъ
носить - та-дыргу
ночевать - се-нгыгу
ночной - пи-тъ
ночь - пи-нъ
ночь темная - твы-ольджибеть
нравиться - нра-винэ-стыгу
нужно - на-добнанъ е-нгъ
ну-ка - а-ра
нынö, нынче - тида-мъ
нынöшнiй - та-мбой, тида-мди
нырковатый - кока-мака, нырка-зей
нырнуть - па-дыргу, па-дкылгу
нюхать, обонять - абсте-етымбыгу
нюхать табакъ - ня-кылгу
нянька - ня-нька
о которомъ - ку-дынчатъ
о маломъ - та-наканчатъ
о многомъ - ко-чинчатъ
о себö - о-ненчатъ
о томъ - на-унчатъ
о чемъ - ка-енчатъ
объ немъ- т<а->бынмынди
объ себö - пи-ренчатъ
объ этомъ - та-унчатъ
оба - сыннэ-
обвязать, [обвязать]ся - са-ргу
обгонять - ка-леква-ндыгу
обдöлить - ма-ла ми-гу
обезсилöть - о-ромкы-лынгу
обöть, обöщанiе - обесча-имбыдимы, обесча-нья
обöщать - сули-мбыгу, обесча-йчигу [исправлено из обещай-мбыгу]
обидöться - оби-дильчигу
обижать - обижа-имгу
обильно - путё-мъ ко-чи е-нгъ
обладать - владе-имгу
облако - ти-тъ
обласкать - свыо-ргу
обласокъ - кыба- а-ндокъ
облегчить - са-пкаммегу
облечься - се-ргу
облизнуться - ню-гуледа-дыргу
облистать - чо-голонбыгу
облистать съ неба - Ну-нъ Ма-данъ ню-гудинъ
облить - га-мджигу
обличать - уличи-мгу
обложить кругомъ - пю-ронгъ пе-нгу, пю-ронгъ квая-льджигу, квая-льджиле пе-нгу
облокотиться - чо-ргыльджигу
обмакнуть - та-кугу
обманъ - а-лрадъ
обмануть - а-лынгу, сизя-ктыгу
обмануться - а-лынчигу, сизя-ктымчигу
обманчивыя слова - сизя-ктымбыди ыэ-чьла
обманьщик - сизя-ктымбыди ко-м, а-лынджанъ
обмотать и завязать - са-ргу
обмывать покойника - мё-золчигу
обнимать, [обнимать]ся - ка-валгу
обнимать за шею - нуко-унтъ ка-валгу
обновка - са-ндымы
обнять - ка-валгу
обо всемъ - ча-лынъ
обогащать - ко-умбыди ме-гу
ободрать звöря - ко-пынты-кыргу
ободриться - перва- ла-рымба т<и->дамъ че-тчигу кыгы-нъ, че-тчигу кыгы-нъ, ине-ланъ э-зыгу, тру-къ ва-рсыватку
обойди мöсто - квая-льджигу
оборвать - лакче-лгылгу
оборонить - парани-лгу
оборотиться - могне- питалгу
оборотиться назадъ - могне- питалгу [строка зачеркнута]
обоюдуострый - а-ублекантъ нежо-канъ е-нгъ, сыто-нъ алиба-
образъ - о-бразъ, Но-мъ
образъ, подобiе - ти-ка пая-
обратиться (къ кому) - питалгу
обращаться ласково - ла-сково точа-жембыгу
обрöзанiе - тема-чимбыдимы
обрöзать - ма-чгу, тема-чьгу, а-тыргу
обрить - ню-кланпю-жигу
оброкъ - ко-ртъ, пла-тъ
обронить - э-стыгу, э-рнигу
обрости - о-рымкылгу
обручь - ча-нгу
обрученiе - обруча-имбыдимы
обручить - обручи-мгу
обсушиться - чаго-етыгу
обтесать - ка-балгу
обточить - се-лъелгу-
обувать, [обувать]ся - се-ргу
обуздать - анга-имтока-льджигу
обучить - оголчо-лджигу
обшевни (сани) - ро-звадни
объяснить - тэ-йербыгу, ка-ткылгу, па-ктылгу
обыкновенно - накаве-нна
овдовöть - са-рымбыгу, ка-лымбыгу
оводъ - пю-
оврагъ - ё-ткыдисо-й
овца - коне-рка
овчина - коне-рканко-пъ
огласить - та-бынчатъ катку-
оглашенный - та-бынмынди ке-тбыди э- -зынъ
оглобля - алла-йпо
оглохнуть - ко-гологу
оглушить - ке-ттыгу
оглядöться - ма-ннембыгу
оглянуться - пи-кильчигу
огненный -тю-йзиди
огниво - сакко-
огонь - тю-й
огребаться - ка-ттыгу
одöваться - че-мбытгу
одöжда - егыда-лъ [исправлено из егылда-ктъ]
одöтый челов[öкъ] - че-мбытбыди
одöться - че-мбытгу
одöться одöяломъ - чо-ндыгу
одöяло - чё-нджь, оде-яла
одинъ - о-кыръ
одинъ другаго - ни-емди
одинъ за другимъ - ня-ндыго-йгонъ
одинъ остался - пе-галкъ
одинаковый - о-кырназа-й
одинокiй - пе-лгыди
одичать - матыльчигу
однажды - о-кырынгъ
одобрить - а-ндугу
одолöнiе - одоле-нья
одолöть, побöдить - одоли-мгу
одолжить - колча-ндми-гу [исправлено из колча-ндмегу]
одурачить - дура-кынъ мету, пе-скугу
ожесточать - жесто-канъ мету
ожесточиться - сво- го-мъ э-съ ай аво-й ме-гумбанъ
ожить, [ожи]влять - иле-димбыгу, иле-етымбыгу
озариться - те-ллыле ю-быргу
озеро - чагэ-
озеро запорное - чво-ръ
озеро карасевое - то-
озлиться - ва-ргынкво-дынбыгу
озлобить - серди-танъ а-стугу, кво-дыльчо-льджигу
ознобить - па-ктыргу
ознобленное мöсто - па-ктырбыдимы
озябнуть - ка-ндечигу
окно - око-ско
около - пю-ронгъ
окончить - ма-льчугу
окружать - пю-ронгу
окружить - квая-льджигу
окунь - ка-за
олень - а-дъача-
оловянный - ня-ургвозъ
омрачиться - лыба-нъ ме-гугу
опаленный - по-рчимбыди, ча-дымбыди
опалить - по-рчигу, ча-дыгу
опасаться - ла-рымбыгу
оплакивать - ку-ндынгъ чу-рогу
оплевать - све-зыгу
опнуться - а-съ ку-ндынгъ эту
опомниться - падче-дигу
оправданiе - оправда-йбыдимы
оправдаться - оправда-йчигу, пра-в<утту> ква-нгу
опрокинуть - кавте- ча-жигу
опустить, пропустить - ю-дыгу
опустить книзу - та ту
опустить курокъ тихо - са-ккумю-дыгу
опустить парусъ - мергега-мъ а-стугу
опустошить - пусто-й мету, сю-дзипюнъ мету
опьянöть - се-ргу
опять - а-йстъ, а-й
орелъ - лы-мпъ
орöхъ - сво-нгъ
оса - лотэ
освöжить - арма-бчигу
освободить (отъ другихъ отнять) - теи-гу-та-ннынгу
освободиться - манчо-лгу, слабо-днанъ э-зыгу, метугу, парани-лчугу, о-ндызе токва-нгу
осöклось ружье - нё-гтымбанъ
осеновать - кы-энгу
осень - ка-ндыкатъ
осетръ - квотеръ
осина - пи-
осиротöть - че-и э-зыгу, те-гаикале-ндчигу
осквернить - скве-рнанъ ме-гу
оскверниться - скве-рнанъ метугу
оскорбиться - оби-дильчигу
оскорблять - кво-дыльчигу
ослабöть - а-лкомме-гугу, сла-бканъ метугу
ослабить - сла-бканъ мету, а-лкомъ мету
ослöпить- се-йгыльчигу
ослöпнуть - се-йгатъ э-зыгу
осмöлиться - ве-ркалъ э-зыгу,
насмöлитчигу
осмолить - са-тку
осмотрöть - ма-ннембыгу
основать - о-мдыльджигу
основать строенiе - са-ндынъ по-<п>ъ пе-нгу, са-ндынъ ма-тымъ мету, са-ндынъ пе-нгу, ю- бы ргу
особо (стоять, лежать) - кра-йгынъ
особый - ко-дъта а-рымъ
оспа - о-спа
осрамить - стра-мна ты ту
осрамиться - страми-тчигу
оставаться - кале-ндчигу
оставить - ка-лтыгу
остановить - у-дыргу
остановиться - у-дыръэ-льчигу
остановка въ дöлö - ара-нъ, ав<о->нъ о-мдальджимбанъ
остатокъ - ка-лымбыдимы
остаться - ка-лгу
остерегаться -токе-скугу
острiе - а-ндъ
остричь - пю-жигу
островъ - о-строгъ
острожникъ - чурме-гамъ а-мнымбыди го-мъ
острый - нумера-нъ е-нгь, нежо-канъ е-нгъ
остудить - казе-етыгу
остыть - канде-зимгу
остякъ - сю-ссого-мъ
остяцкiй - сю-ссогой
осуетиться - тэ-йербыгу што-бъ греши -тчигу
осуждать - осужда-имгу
осужденiе - су-дымбыдимы
ось - о-сь
отъ - то-, до-
отъ - до - ... а-ндо - ... чанъ
отъ бога - Нунна-ндо
отбöжать - текуро-лгу
отбросить, [отбросить]ся - точа-джигугу [исправлено язто-чаджигугу]
отвалить - илле- пе-нгу
отвöдать - са-кугу, про-баи мгу
отвергнуть - точа-джигу
[отвергнуть]ся - [точа-джи]чи ту
отвергнуться - а-съ ка-птыгу
отвернуться - пи-галгу
отвертка ружья - отвё-рка
отвöтить - келеда-дыргу
отвöчать - келледа-дыргу
отворить -ню-гу
отвориться - о-нденю-гу, ню-гучигу
отворотить -а-рынчигу
отвратить - а-рынчигу
отвязать - тече-чугу
отвязаться (отъ кого) - токва-нгу
отгребать - гадо-лгу
отдавать о ружьö - могне- та-болгу
отдаваться - квере-нчигу
отдать учиться - на-гыртоголчо-лджиле ми-гу
отдöлить - а-рынъ ю-дыгу
отделиться - малква-нгу
отдохнуть - ква-скальджигу [исправлено из кваска-л ьджигу]
отдохнуть сöсть - ква-скальджигу о-мдыгу
отдыхъ - о-тдыкъ
отецъ - э-зелъ
отказать - а-съ ми-гу
отказаться - откази-мгу, а-съ ква-нгу
откликаться - квэ-ргу
откликнуться - ла-нгалгу
отклониться - ко-кылгу
отколупнуть - то-гатолгу
откормить - путё-мъ а-бстембыгу
откормленный - путё-мъ а-бстембыди
открытiе - ню-гумбыдимы
открыто дöлать - а-съ та-умнымбыдимы
открыть - ти-дгу, ню-гу
откуда - куте-ндо
откусить - са-джигу
отличать - отличи-мгу
отличаться - лу-ччинъ э-зыгу
отложить - топе-нгу
отломить - мо-рку
отломиться - са-бытку, сепе-димгу
отмстить - аво-ймымъ ме-рчигу, аво-йзе могне- ми-гу
отмщенiе - аво-ймымъ ме-рчимбыдимы
отодвинуть, [отодвинуться - теча-кол ьджигу, кве-нч<а-> кол ьджигу
отойти - токва-нгу, точа-жигу [ исправлено из точ а-джигу]
оторвать - ла-кчигу
оторваться - се-ппыдигу, ла-кчичугу
отпасть (листъ) - пы-нгылгу, топы-кыльчигу
отпираться, отперöться отъ чего - а-съ катку-
отплыть - топа-льджигу, то ква-нгу
отпоръ дать - кве-ссе те-ттыгу
отпроситься - ма-дырчигу
отпустить - ю-дыгу
отражать (предм[еты], лучи) - те-лдъ аде-зигу
отражаться - тонче-нъ эту
отражаться въ водö - ё-тъ
аде-зигу, ю-тонъ ча-жекаги аде-зигу
отраженiе тöни - тика-пая
отразить нападенiе - кве-ссете-ттыгу
отребiе - атро-пка
отрекаться - ыэ-чьлазе а-съ кы-гыгу
отрепья - атро-пка
отречься - откази-мгу
отрокъ - кыба-гомъ
отростокъ - чара-й по-
отряхнуть - чоба-лгу, ласке-етыгу
отсöчь - келпача-лгу, окырпача-лгу
отставить - поне- ме-лдчь мачко-льджигу
отставить (отъ дöла) - то ю-дыгу
отставной - тою-дымбыди
отставной солдатъ - солда-тъ ко-нте тю-мбанъ
отстать - токва-нгу
отступить - могне- леле-дигу, могне- чи-гальджигу
отступить (от кого) - токва-нгу
отступить (отъ слова, отъ Закона) - зако-нанъ асъ ме-гу, зако-нандо могне-леле-димгу
отсчитаться - то-гольджигу
отсырöть - ю-дугу
отсюда - ты-ндо
оттепöль - пёэ-земба
оттолкнуть - пере-лгу
оттолкнуться - но-голгу
отторгнуть - ла-кчигу
оттуда - наче-ндо
отчетъ - отчё-тъ
отыскать - коту
отъöхать - токва-нгу
охладить - казе-етыгу
охотно - кыгыде-нзе
охотно - о-нде ко-ткатъ
охранять - караву-мбыгу
оцарапать - га-долгу
оцöнить - сени-мгу, ме-римчигу
оцöпенöть - ко-ндалбыгу
очевидöцъ - ку-дъ ко-нджирбанъ, о-нде ко-нджиркудъ
очень - ка-ндыбынгъ, путё-мъ
очень длинный - канра-
очень старый челов[öкъ] - безме-рыэра-й го-мъ
очень тяжелый - тя-джелбатъ
очертить - по-зе ко-ромбыгу
очистить - нё-рбалгу
очиститься - нё-рбалчигу
очищенiе - нё-рбалбыдимы
ошибиться - мако-димгу
ошибка - мако-димба
пагубный - ква-ткудъ
падать - пы-кыльчигу
паденiе - пы-кыльдико-ндимы
палецъ - му-нъ
палецъ ноги - то-пынму-нъ
палить покосъ - ча-дыгу
палка - по-
палка, посохъ - чу-рръ
палка для лыжъ - чу-рръ
палочка - по-нби
пальникъ (тетерька) - сю-ва
панги (обувь) - пе-у
память - па-мять
паръ - каш ко-у
парить (орелъ) - пю-ронгой ва-тöа
парное молоко - па-ргылба молоко-
парусъ - мергега-мъ
пасмурный - кашко-йди
пастись (о скотинö) - а-ворле па-льдчигу
пастухъ пасетъ - пасту-къ гани-мбанъ
паукъ - коча-пая
паутина - по-нгыпатъ
пахать - паха-йчигу
пахнуть - а-етигу
пашня - па-шня
пöгiй - пе-гай
пеленать ребенка - кыба- ня-чамъ та-мгылгу
пöна - си-боргна
пень - са-лдчь
первенстволюбецъ - кудъ пе-рванзе эту свыо-рытъ
первый - пе-рвай
перевернуть - а-убликать питальджигу
перевести, [перево]дить (книгу) - переводи-мгу
переворотиться - поро-льджичигу
перевязывать, [перевя]зать - те-чикугу
перегородка - ара-нъ
передать - ми ту
передвигать - ча-кыльджигу
переднiй -ня-нней
переднiй уголъ - Но-мъ а-мдете утолчь
передняя нога - уть
передовая - ня-нней
передразнивать - кве-ренджигу
переöхать рöку - урлетё-чугу
перекликаться - па-ркугу
перекопать - сы-дымчелпакыледа-дыргу
перекреститься - кы-лыно-лымба-дельбыгу
перекрестокъ - кресто-зынъ у-лиса ква-нбанъ
перелазить, перелöзть - че-реза-залгу
перелетный - ти-мбыди
переломить - ла-кчигу
перемöна - переме-на
перемöнить- та-ргу
перемöниться - а-рынъ метугу, а-съ ны-льди метугу
перемöшать - ко-дельдчигу
перенимать - ка-вальджигу
переносить (съ моста) - а-рынъ че-тчигу, то-голгу
переносить горе - терпи-мгу
переносье - пучино-лымба-ръ
переобразоваться -та-рчимбыгу
переплыть - у рлетё-чугу
перепрыгнуть - па-ктыгу
переселить - пересели-мгу
переселиться - пересели-тчигу
пересöсть - а-вмынъ омдыту
перескоскочить [вместо
перескочить] - па-ктыгу
пересолить - ко-чинъ са-кыдгу
переспорить - спориса-тчимбанъ
перестать - уды ргу
переступить, [пересту]пать - нельдчо-лдчигу, че-резъ леле-димгу, че-резъ а-залгу
перетаскать - ту-голгу
переулокъ - переу-локъ
перешагнуть - а-залгу
перина - пери-на
перо - та-ръ
перо для письма - перо-
перстень - му нынгвозъ
пöсня - ко-ймъ
песокъ - кора-
пестрый - пё-страй
пöть - ко-тымбыгу
пöть старинку - квэ-лджимбыгу
печалиться - таску йчигу
печаль - печа-ль
печальный - а-ндалгыди
печать - печа-ть
печеный хлöбъ - ня-й мембыди
печень - ка-йно-лъ
печись - забо-тимгу
печь - со-хоръ, пе-чка
печь въ карамо - чува-лъ
печь хлöбъ - ня-емъ мету
пöшкомъ - утета-нъ
пещера - ко-вула
пила - ва-ргъ си-псенъ
пировать - ю-дгу, ара-нка ю-дгу на-да
писанный - на-гырбыдимы
писать - натенджигу
писканiе дудкой - ыэ-чьжимбыдимы
письменное посланiе - натыръ
письмо - натыръ
питательный - ка-пучимбыдимы
питаться - пита-йса-тчигу
пить - ю-дыргу
питье - ю-дырбыдимы
пихта - ка-де
пища - а-бсотъ
плавательное перо - ту-тъ
плавать - па-льдигу, ургу
плакать - чу рогу
пламенный, огненный - тю-йзиди
пламень - тю-но-лъ
пламя - тю-й
плата за труды - пла-тъ труда-стъ
платить - ме-рчигу
платокъ - ка-умбе
платье - пла-ти
плачь - чу ронъ, чу рымбыдимы
плеваться - све-зымбыгу
плöнить- па-ктыле ча-быгу
плöнный - па-ктыле ча-бымбыди ко-мъ
плесень - пальча-
плеснöвöть - пальча-жлеча-жигу
плести - плети-мгу, па-ргу, па-тку
плетенiе - плети- мбыдимы
плетенка - корзинка
плечо - кута-у, квандпа-ръ
плöшивый - нё-лайо-ли
плодъ древесный - чо-быръ
плодиться - ё-дыргу, ё-дырлеча-жигу
плодоносный - ко-ресю
плоть (бревна) - пло-тъ
плотва - пете-
плотный (о матерiи) - пло-тн<ый>, сво-мы
плоть - ва-ть
плуть - во-риго-мъ
плюнуть, [плю]вать - све-зыгу
пляска - пакте-лбыдимы
плясать - пакте-лбыгу
по (чему) - о-унтъ, о-ндутъ (послö существительного]) [ строка зачеркнута]
(öх[ать]) по водö - кю-нъ мого-лъ
по всему видно - се-ланъ а-донъ
по головö - оло-унтъ [строка зачеркнута]
по дереву - по-гото-ндутъ [ строка зачеркнута]
по дорого - вато-гунтъ [строка зачеркнута]
по лöвую руку - кво-дблекатъ
по лицу - вандо-унтъ [строка зачеркнута]
по мöрö воры - ме-ранзе ве-рамъ, но-мтъ ве-рынэ-зынъ Но-мъ та-ткудъ
по порядку - ма-стерынгъ, поря-дкамъ
по правую руку - та-дблекатъ
по пути - попути-
по рукö - уто-унтъ [строка зачеркнута]
по совöсти - со-вестынзе
по человöку - го-мгойто-ндутъ [ строка зачеркнута]
по щекö ударить - ча-ндж<и>епенква-тгу
побöдить - одоли-мгу
побöда - одоле-нья
побои - ква-тбыдимы
побороть - ора-лгу ай э-стыгу
по-братски - тимня- сы-къ
поваренка - кво-зкала
повернуться - койва-тку
повöсить - э-тыгу
повести - ква-ннынбыгу
повöшенный - э-тембыдимы
повивальная бабка - о-тонъ ко-мъ пая-
повиноваться - ю-нгольдчигу
повиновенiе - ю-нгольджимбыдимы
повиснуть - ётерко-джигу
поводъ узды - по-водъ
поворотить - тепи-кальджигу
повредить - вреди-мгу
повстрöчаться - ко-гочигу
погибель - сме-рть, поги-бель
погибнуть - кулеча-жигу
погладить по головö - о-лымны'<н>галгу
погода, вöтеръ - пого-да
погодя немного - э-ттангъ э-лебе
погонять - ка-ннингу
погребъ - потребъ
погребать - о-чимгу
погубить - катынбыгу
подъ - Ы'ЛЪ, Ы'ЛОГЫНЪ
подъ землею - тюны-логынъ
подавиться - сю-льгу, ноке-зигу
подарить - подари-нгу, ко-зынгу
подарокъ - ко-за
подать милостыню - ми-лостынямъ ми-гу
подать настоль - та-тку
подать примöръ - приме-ръ ми-гу
подбöжать - тикуро-лгу
подбодриться - поджо-льджимбыгу, на-ркальджигу
подбородокъ - пета-й
подвигать - ю-голгу
подвигаться - ня-нненъ лаго-льджигу
подвизаться -те-ттенбыгу
подвинуться - ча-кольджигу
подговорить - ча-зыргу
поддаться - поддава-йчигу
поддерживать - орала-гынбыгу
поджать ноги - иннекаро-льджигу
поджигать - ча-дыгу
поди прочь - тё-къ ва-нкъ
подкошенный - па-чалбыди
подкрадываться - кво-нчигу
подкупить - та-угу
подлö - ко-йгынъ, кё-югей, коддерганъ
подлезть - ы-логынпа-тку


подлить - ещё га-мджигу
подложить - ы-лотпе-нгу
подмерзать - канде-дигу
подмигнуть - се-ймдъ мыре-тчигу
поднебесный - нунсинче-ганы-лонди
поднести корту - а-гынтъ та-тку
поднимать - ва-тчигу
подниматься - ва-зыгу
подносъ - подно-съ
подносить гостямъ - та-больджигу
поднять - ва-тчигу
поднять вверхъ - и-ннева-тчигу
поднять глаза - котте- мандже-зигу
поднять парусь - ме-ргега-мъ мизе-лгу
подняться - ва-тчичигу
подобiе - ти-ка пая-
подогрöвать - пё-тчигу
пододвинуть - а-й а-внетчаго-льджигу
подозвать - кво-релбыгу
подойти - табне- ча-джигу, тю-нджигу
подослать - ю-дыгу
подошва - то-пынылчь
подперöть - нуго-льджигу
подперöться - нуго-льджичугу
подпилокъ - си-пса
подпираться палкою - чу-ргольджигу
подписаться - натыро-льджигу
подпоясаться - кю-ндогу
подражатель - ны-льди жа ме-кудъ
подражать - ны-льди жа ме-гу
подраться - те-ттыгу, дра-кыса-тчигу
подружиться - дру-жна-нъ ю-бырлеэ-зыгу
подсвöчникъ - посве-шникъ
подсматривать - тво-лакан ма-ннембыгу
подставить - илле-ндимачко-льджигу
подтолкнуть - мизе-лгу
подъустить, подъучить - оголчо-лджигу, о-дальджигу
подъучить на зло - оголчо-лджигу
подушка - ню'соготъ, поду-ска
подхватить - о-ралгу
подходить - тю-нджигу
подчиниться - уто-гемызе ме-гугу
подъöхать - тюлеми-дымбыгу
по-его - та-бтарэ- [строка зачеркнута]
пожалöть - жале-имгу
пожаръ - пожа-ръ
по-жидовски - жы-дысе-тчанъ [ строка зачеркнута]
позариться - поза-рингу
позвать - квэ-релбыгу
поздно - по-зно, ю-демыганъ
позöвнуть - а-мымбыгу
познанiе - ко-стымбыдимы
поймать - оралпе-нджигу, ора-лгу, ча-быгу
поить - юто-льджигу
показать - а-дольджигу
показываться - а-жигу - а-донъ, а-жизанъ, а-жемба, а-жич<а>нъ
поканаться - по-маралгу
покатиться - незо-лгу
поклониться - о-кыро-мдалгу
поклониться въ ноги - то-пынды пы-нгыле о-мтыгу
поклониться въ поясъ - путё-мъ о-мтыгу
покоиться - кю-ганъ э-пегу
покойникъ - ката
покойно - поко-йнанъ е-нгъ
покойно жить - ма-стерынгъ э-лгу
покойный (объ умершемъ) - поко-йникъ
покорить - покори-мгу
[покорить]ся - покори-тчигу
покорный - поко-рнай, ю-нгольджимбыди
покоряться - ю-нгольджигу, поко-рнанъ э-зыгу
покосъ - поко-съ
покрытый сыпью - ча-рымбатъ
покрыть - ка-йгу
покумиться - кумау-гу
покупатель - тамты-нъ


покупать - та-мтыгу
полъ - са-лджипо
полати - пола-ти
пол года - по-нтгосъ
полдень - телдква-ска
поле - чи-стай ню-ртъ
ползать (о живот[номъ]) - со-кыргу
ползать (о челов[öкö]) - незо-льджимбыгу
ползающiй - со-кордимы
полизать - ню-голгу
полка - по-ръ
полно накласть - чузети-ергу
полно налить - ти-ергу
полно насыпать - ти-ерлега-мджигу
полный - ти-еримбыди
полнымъ сдöлать - ти-ерлемегу
половина - ква-ска
пологiй - ле-балагъ е-нгъ
положить - пе-нгу
положить за пазуху - <о->мгальдже-нджигу
положить на него руки - уто-нъ табни- пе-нгу
положить на плечо - ме-ндалгу
положить на сошки (ружье) - по-ндапе-нгу
полосатый - чё-мбыгытъ на-гы рымы
полотенце - ва-ндмыти
получить - получи-мбыгу
полынья - не-мба
польза - по-льза
пользовать - по-льзамъ мету
полюбить - свыо-ргу
помазанiе - ма-зимбыдимы
поместить въ себö - па-дчигу
помöшать чöму - меша-ингу
поминать покойниковъ - помина-имгу
поминки - помина-имбыдимы
помирить - мири-<т>чигу [зачеркнуто], мири-мгу
помириться - мириса-тчигу


помнить - тэ-йрбыгу
по-моему - ма-нтарэ- [строка зачеркнута]
по́мочь - по-мочь
помощникъ - пе-лдымкунди ко-мъ, помога-имбыди ко-мъ, помо-сникъ
помощь (пособiе) - пе-лдымбыдимы
помочь, [помо]гать - помоги-мбыгу
помрачить - лыба-нъ мету
помыслить - тэ-йрбыгу
помять - пе-ктылгу
поновить - са-ндынъ мету
поносить - ты-ндугу, ты-гу
понюхать - сижо-льджимбыгу
понятно - понятно
понять - ко-стыгу
пообöдать- а-воргу
по-остяцки - сю-ссогойсе-тчанъ [ строка зачеркнута]
попадать на встрöчу - ко-гочимгу
попасть въ ловушку - кё-тембыгу
попасть въ сöть (о рыбö) - по-кондъ кво-дыгу
попасть въ силокъ - кво-тымбыгу
попасть на камень - пю-ллага че-джимба
поперек - а-ртъ
попирать ногами - то-пызе нельдчо-лгу
попить - ю-доре-льчигу
пополнить - тi-ергу
попутный вöтеръ - мого-лъ ме-ргъ
попутчикъ - поту-т<.>икъ
попятиться - могне- ча-кыльджигу
по-прежнему - уко-льджарэ-
по природö - ни-льдингъ те-лымбанъ
пора вечерняя - ю-ди пора-
пора идти - пора- ква-нгу
пора утренняя - ка-ри пора-
поработить - поработи-мгу
поработиться - пи-ремтъ уто-гемыгле ме-гу
порогъ - ма-данъ до-бъ
поросенокъ - кыба- сыбындя-
порохъ - по-рокъ
пороховница - атру-шка
портить (обо всемъ) - пана-лгу
порука - пору-ка
по-русски - каза-гынсе-тчанъ [ строка зачеркнута]
поручитель - паруча-имбыди ко-мъ
поручиться - поручи-мгу
порхать (бабочка) - ти-мбыгу
порядочный - поря-дошнай
посадить дерево - о-мдальджигу
по-своему - о-ндетарэ
посвöтить - по-рчимбыгу
поселиться - сели-нгу, сели-тчигу
посöтитель - чадзе-и ко-мъ
поскользнуться - не-зольдчигу
послать - ю-дыгу
послö - капче-, мо-гоне-нъ
послö этаго - капче- та-умы
послöднiй - по-смогне-нъ
послöдовать - вато-унтъ ква-нгу
послöзавтра - а-гделъ
послушанiе - ю-нгольджимбыдимы
послушать - ю-нгольджигу
послушаться - ю-нгольджимбыгу
послушно - послу-шнангъ
послушный сынъ - ю-нгольджимкунди и-дъ, сво- и-дъ
посмотрöть - ма-ннембельчигу
пособiе - пе-лдымбыдимы
пособить - пе-лдыгу
посовöтовать - сове-таимгу
посолить - сы-кыдгу, сы-кыдыльчигу
посохъ - чу-рръ
поспöлъ или нöтъ (обöдъ) - мю-зоромбанъ, а-ль а-съ
посрамиться - стра-мнанъ э-зыгу
посредствомъ - зе-
поставить выше всöхъ - пы-ргынъ ве-сь гу-ланъ ны -льджигу
поставить кого - ны-льджигу
поставить что - че-тчегу, мачько-льджигу
постöль - ча-нгозъ, ко-птъ
постепенно - чё-нджика-нъ
поститься - по-стутчигу
постлать - ча-нынбыгу
постой-ка - о-ла
постоять - а-съ ку-ндынгъ ны-нгыгу [исправлено из а-съ ва-ргъ ны-нгыгу]
постращать - ларчимбыгу
посылать - юде-нчигу
потъ - нельдчутэ-
по-татарски - ты-йсе-тчанъ [ строка зачеркнута]
по-твоему - та-нтарэ- [строка зачеркнута]
потемки - лы-баканъ
потемнöть - лыба-нъ ме-гугу
потеря - ё-рчимбыдимы
потерянный - ё-рчимбыди
потерять - ё-рчигу
потеряться - ё-румбы гу
потöть - нельдчигу-
потихоньку - чё-нжикангъ
потолокъ - потоло-къ
потомъ - нынбле-
потомки - и-ндыла
потому - на-мывунъ
потому что - на-но, на-узе што-
потребовать - кво-ргу
потроха - кэ-тъ
потрясти - лаго-льдчигу
по-тунгусски - тунгу-зсе-тчанъ [ строка зачеркнута]
потушить - ка-птыгу
потушить пожарь - пожа-рымка-птыгу
потчевать, по[потчевать] - по-тчиваингу




поужинать - а-воргу
похвала - а-ннымбыдимы
походить немного - та-ллепа-льдечигу
походка - па-льдинъ
похожiе др[уг] на друга - нэ-депю-ттиди
похожiй - пю-тти
похоронить - карани-нгу, О'ЧИНГу
похотöнiе - ва-тизиди кыгыде-
поцелуй - ни-дымбыдимы
почему - ка-йнго
почернöть - сетлагь э-зыгу
почерпнуть - со-голгу
почесть - че-сть
почетъ - че-сть
почетный жит[ель] - ка-жнай ко-мъ почита-имбатъ
починить - пра-вимгу
почка дерева - ка-на
почтенный - сво- го-мъ
почти - всё равно-
пошатнуть - лаго-льджигу
пошатнуть - о-кырынгъ лагыргу [исправлено из лагырчугу]
пошатнуться - че-пыкыльчигу
[пошатнуть]ся - о-кырынгъ [лагыр]чигу [исправлено из -чугу]
пошелъ - ча-нджемба
пощадить - жале-имгу
пощечина - ча-нджибенъ ке-ттымбыдимы
пощупать - пю-гульджигу
поэтому - та-умывунъ
поэтому то - та-умывунъ та
поясъ - поя-ска, кю-
поясница - ку-ндемо, кю-ндемо
прабабушка - ещё ба-ушка
правая рука - та-де у-тъ
править - пра-вимбыгу
православный - правосла-внай
прадöдушка - ещё де-душка
праздникъ - ну-льдзелъ
праздновать - нульдзе-льчигу
праздность - <асделазе-> э-зыгу
прать (перöть впередъ) - <пер>е-льджигу
пребывать - завсегда- э-гу
превозмочь - одоли-мгу
превратиться - метугу
преграда - ара-нъ
предъ - га-тгендъ
преданiе - ка-й и-ри гула ми-мбатъ, и-ри гула-ндо кура-льджимбыдимы
предвöдöнiе - ня-нненъ ты-ннымбыди
предки - и-рикула
предполагать - ня-нненгъ тэ-йербыгу
предположенiе - ню-рбыдимы
предсказать - ня-нненгъ катку-
представить - та-тку
представить въ умö - тэ-йрбыгу
предстатель - пе-лдымбыди го-мъ
предувöдöнный - могне- ты-ннумбыди
предувöдомить - уко-нъ катку-
предупредить - уконъ катку-
предшествовать - уко-лча-жигу
прежде - уко-нъ, ня-нненгъ
прежде другихъ - уко-нъ а-урба
прежде нежели - уко-нъ на-умы, кунда-ръ
прежде !!!узна<...> - могне- ты-ннумбыди
прежнiй - уко-й
презирать - асъ свыо-ргу
преклонить голову - о-лондъ мы-н кугу
прекословить - кё-гонъ че-нчигу
прекратить - у-тыргу
прекратиться - у-тырчигу
прекращенiе -у-тырбыдимы
прелестный - нра-винэ-стыкунди
прельститься - поза-рингу
премудрость - путё-мъ ва-ргъ тэ-й
препона - ара-нъ
препятствiе - ара-нъ
препятствiе въ дöлö - аво-нъ о-мдальджимбанъ
препятствовать - меса-имгу
преслöдовать - та-нгынбыгу

преступить - че-резъ а-залгу
преступленiе - преступле-нья
преступникъ - черезъ зако-нъ а-залкунди ко-мъ, преступникъ
претк[н]уться (запнуться) - табо-лгу, тапо-лбаты пы-кыльчигу
прибавить - приба-вимгу
прибöжать - ме-нтетю-мбыгу
прибöжать для защиты - ма-дыргу
прибöжище - ку- ква-нгу, ку¬ку ро-лгу
прибить гвоз[дями] - ти-бынлазе ке-тыгу [исправлено из кё-ттенбыгу]
приблизиться - чардзе-канъ э-зыгу, табни чажигу, табни- ми-дыгу
прибодриться (фертомъ) - поджо-льджимбыгу, на-ркал ьджигу
прибывать о водö - ме-чигу, мё-дзимбыгу
привалить - мачько-льджигу
приведенiе - та-тбыдимы
привезти - та-тку
привöтить - свыо-ргу
привлечь - ня-кыгу, та-ктылгу
приводить на память - тэ-ербыгу
привыкать, привыкнуть - огуле-нджигу
привязать - са-ргу
пригладить - гла-димгу
пригнать - ка-ннингу
пригнуть - ка-рольджигу
пригоршни - сыдъо-ра
приготовить - гото-вимгу
приготовиться - гото-ванъ э-стыгу
придавать - еще ми-гу, прида-чамъ ми-гу
придавить (чöмъ) - ча-нгро-льджигу
прiöхать - тю-мбыгу, тю-гу
прижать - ы-пколгу
прижаться - то руко-льджигу
призванiе - квыа-рбыдимы
признать, узнать - ко-стыгу, кё-тыльчигу





признаться - ка-тпыгу
призывать имя божiе - Ну-нъ- Н<е-ме> квыо-ргу
прiйти - тю-гу, ми-дыгу
приказать - кура-льджигу
приклöить - тутгу
приключенiе - ны-льди случай
прикоснуться - о-лао-ралгу
прикрöпить - крепка-нъ мету
прикрытiе - ка-ембыдимы
прикрыть, [прикры]вать - а-съ <ва-ргынъ> ка-йгу
прилагать - еще пе-нгу
прилежно - путё-мъ мету
прилежный - кытынди, трудиса-тчиндиго-мъ
прилöпить - пока-льджигу
прилöпить- парчугу
[прилöпить]ся - [пар]чичугу
прилетöть - тю-гу
приложить - а-й пе-нгу, мач ко-льджигу
приложиться изъ ружья - п<у->д<о>лджиле (пидо-, пудэ-, пидэ-, пегдо-, пегдэ-?) ча-лджигу
прилучиться - случи-тчигу
применить (къ чему) - та-рчигу
примöръ - приме-ръ
примöрный - приме-рнай
примотка - приме-тка
примиренiе - мири-сатчимбыдимы
примирить - мири-нгу
примириться - мириса-тчигу
приневолить - заста-вимгу
принести - та-тку
принудить - заста-вимгу
принять, пустить - ю-дыгу
прiо[б]рöсти - и-гу
прiобрöтать - нажива-йчугу
прiобщать реб[енка] - Ну-нъ юссе- юто-льджигу
прiобщаться - Ну-нъ юссе- ю-дырчигу
прiобщаться св[ятыхъ] т[айнъ] - Нунъ абсо-тымъ а-мгу
приплыть - у-рлекуптыгу
присöсть - о-мдыгу
присматривать - ма-ннембыгу
причащаться св[ятыхъ] тайнъ - Нунъ абсо-тымъ а-мгу
причесть - окырмыгы-нъ то-ренджигу
причислить - окырмыгы-нъ то- рэн джигу
пришить - сю-тку
пришить заплату - каби- кабигу
пришлецъ - а-съ ты-нди ко-мъ, а-рынъ ко-мъ, ку-дъ тю-мбанъ, тю-кудъ
пришпилить (бул[авкой]) - со-нгыргу
прищемить - ы-пколгу
приятный на вкусъ - вку-снай
провожать - ми-мокуро-лгу
пробираться - ква-ллеча-жигу
пробовать - про-баимгу
пробудиться - сы-дычигу
пробуждать - сы-дыгу
пробыть - э-гу
провалиться - пы-кыльчигу
проводить день - те-легендъ ква-ддыгу
провожать - понече-дчигу, проводи-мгу
проводить жизнь - э-д<о>тде ква-ддыгу
проглотить - а-мгу, полле-чимбыгу
прогнöвлять - кво-дыльчигу
прогонять - ка-ннингу
прогуливаться - та-ллепа-льдчигу
продавать - ме-риргу
продавецъ, купецъ - та-много-мъ
проданный - ме-римбыди
продать - ме-рылледа-дыргу
продираться - ква-ргылеча-жигу
продолговатый - чумбулагъ енгъ
продолжать - а-й ко-ла мету
прожить (деньги) - тра-тимгу, тра-тиледа-дыргу
прозвать - кво-аргу
прозрачный - наскро-зь атра-нъ
прозрöнiе - тру къ се-йды ню-гучанъ

пройти - ми-моча-джигу, ме-ндыгу
пройдти (о времени) - ме-нтыгу
пройдти двö версты - ми-дыгу
проиграть - ча-дчигу
произрастать - те-лынгеча-жигу
произшествiе - ны-льди случай
проклинать - кыча-тчигу
проколъ болöзнь - кю-стимы
проколоть - че-резчоко-льджигу
пролетöть - вазе-чи-мбыгу
промыселъ звöриный - су ри про-мыселъ
промыселъ рыбный - кво-лли про-мыселъ
промахнуться - ы-къ чарку ю-румбыгу ко-рынъ е-нгъ
промчаться - чанме-ттыгу
пронзить - почо-льджигу
пропадать - ю-рымбыгу
про́пасть - кра-льди нэ-и ча-нгванъ
проплясать - пакте-лбы гу
проповöдывать- пропове-даимгу
пропустить - ю-дыгу
прорвать - ны-чкылгу
прорöзать - ма-чьгу
прорицать - ня-нненъ катку
прорубить - наскро-зь пача-лгу
прорубь - а-рамо
просвöтить - све-тланъ ме-гу
просöчь - че-резпа-челгу
просöять - лаге-ттыгу


просить - ма-дыргу, сотончагу [зачеркнуто]
просить милостыни - Ну мъды ма-дыргу
проситься - ма-дырчигу
прославиться - пи-ремтъ а-ндугу
прославленный - ква-ллимбыди
прославлять - а-ндугу, ква-ллимгу
прослезиться - чу рогу се-йндгай га-мджигу
простить - кво-чьгу
проститься - прощайчигу
простодушный - та-дынче-нченгъ
простой человöкъ - та-дынь го-мъ
просторный, просторно - э-нгылье-нгъ
простота - простота-
пространно - ча-ндженгъ
простудиться - простуди-тсанъ э-зыгу
просьба - про-сьба
протекать о рöкö - кё-нгугу
протерöть глаза - се-йна-ткольджигу
протöсниться - ква-нгу
противно - паганъ
противиться - а-съ ю-нгольджигу, кё-гонъ ны-нгыгу, кё-гонъ ква-нгу
противъ - кё-гонъ ва-рка, кё-йгондъ
противъ воды (öх[ать]) - кю-унъ- кве-се
противный вöтеръ - кве-се ме-ргъ
проткнуть - черезъ пожо-льджигу, почо-льджигу
протоптать дорогу - ва-тымъ тапчи-мгу
проторить - ча-нджинъ не-льджолгу
протрезвиться - подче-дигу
протянуть ноги - то-пынка-нгылгу
протянуться - ка-нгыльчигу
проучить - оголчо-лджигу
прохладно - кыба- а-рма те-лею-бырытъ
прохладный - мерге-бчимбыди
прохладный (о днö) - те-лдъ ва-ргынъ пю- а-съ е-нгъ
прохлаждать - мерге-бчигу
процöдить - нере-плида-дыргу
прошедшiй - ква-ндыкудъ, по-нду
прошенiе - про-сьба
прошлогоднiй - по-нгу подъ
прошлый - по-нду
прощай - проща-й
прощаться - проща-йчигу
прутъ - ма-къ
прыгать - па-ктыргу
прыгнуть - па-ктыгу
прыжокъ - па-ктырбыдимы
прялка - пю-рчигужунъ
прямой - та-дынъ е-нгъ
прясть - се-гаммегу
птенцы - ийма-тлау
птица - ну нсу-румъ
птичка - нунсу-румби
пугать - ла-рчигу, кэчо-льджигу
пугаться - ла-рчимбыгу
пугливый - ла-рымбыди
пуговица - сыдже-нъ
пузырь - сюзюго-жа
пуля - пуль
пустая дорога - пусто-й ва-тъ
пустить - ю-дыгу
пустой - сю-дзипюнъ е-нгъ
пустынная дорога - пусто-й ва-тъ
пухъ - пукъ
пуховый - пуксой
пушистый - чабырга- е-нгъ
пчела - пчё-ла
пыжъ для заряда - пы-шка
пылить - пу ргыргу
пыль - пурга- [зачеркнуто], качьку-
пыхтöть - си-жимбыгу
пьяница челов[öкъ] - юе-ренди го-мъ
пьяница ягода - ко-дыкъ
пьяный - се-рбатъ
пятка - мо-тча, ы-рчитъ
работа - рабо-та
работать - работа-тчигу, у-чьгу, о-рчугу


работникъ - рабо-тныкъ
равночестный - ны-льди жа че-стнанъ е-нгъ
равный - о-кыръ са-нье-н<г>ъ
радъ - а-нталбанъ
радоваться - а-нталбыгу
радостно - а-нталбле
радость - а-нталба, ра-дасть
радуга - ю-деретъ четчу-женъ
разбöжаться - малкуро-лгу
разбöжаться врозь - сытовасватку
разбросанный - точа-джимбыди
разбросать - ке-лынгу, тя-желгу
разбудить - сы-дыгу
разбудиться - сы-дычигу
развалиться - каве-дигу
развö - аразе-
развöсить - ы-дгу
развести что - э-зыгу
развивать - са-нчелгу
развить - па-лгылгу
разворочать - уто-зе ке-лгу
развратить - по-рчимгу
развязать - те-чьчугу
разговаривать - келеда-дыргу
разграбить - то-лбыгу
разгрузить - конне- мя-ктынгу
разгрызть - пу-чолгу
разгульный - разгу-льнай
раздавать [вместо раздавить] - че-лгынгу
раздавить - чи-кылгу
раздавить ногою - то-пызе чи-кылгу
раздать, [разда]вать - миле-дадыргу
раздать кому - ме-лалкынгу, ме-гылгу
раздöваться - ня-выску
раздöлить - та-ргу
раздöлить пополамъ - та-ргу попола-мъ
[раздöлить]ся - [та-р]чигу
разделиться (разойтись) - малква-нгу
раздражить - дразни-нгу
раздразнить - дразни-нгу
разжать руку - ча-ндчо-голгу, ню-гу
разжечь - ча-дыгу
разжечься - пи-ремтъ ча-дыгу
разживаться - ко-вулею-быргу
разинуть ротъ - ти-догу
разлить - га-мджигу
разлиться - весь ча-нжалгу
различать - отличи-мгу
различный - ра-знай
разложить - ма-лпе-нгу
размотаться - кондо-лбыгу
размножиться - ко-чинъ э-зыгу
размокнуть - ё-дымбыгу
размочить - ёде-птегу, чабте-бтыгу
размякнуть - ёдо-умбыгу
разниться - а-съ ня-мди пю-тти э-зыгу
разный - ра-знай
раз[о]брать - разбира-имбыгу
разойтись - малква-нгу
разорвать (человöка) - нэча-ргу, ла-книгу
разорвать одöжды - нэча-рледа-дыргу
разорвать порохомъ - пасе-дигу
разорваться - ны-чкыльджигу
разорваться съ досады - ла-кчичугу
разоренье - разоре-нья
разорить - разори-мгу
[разорить]ся - [разори-м]чигу
разостлать - чанго-птымбыгу
разрешить вопросъ - толкава-имгу
разрушить - каве-димгу
разуваться - ни-нку
разумъ - тэ-й
разумöть - тэ-йрбыгу
разъöхаться - малква-нбыгу
разъяренный - си-льнанъ те-мбыди
рай - ра-ль
рама - ра-ма
рана боевая - ра-нъ
рана болöзненная - пе-нкъ
ранить - ра-нъ ме-гу
рано - эрте-
раскалить - ня-ронъ по-рчигу
раскалиться - патчо-лгу
раскинуть - ко-ннымбыгу
разклониться - квоте-монгу
раскрыться - ню-гучигу
разпалить - по-рчигу
разпалиться - пи-ремтъ по-рчигу
распилить - пили-нгу
разплавить - ча-дыгу
разпрягать лош[адь] - теса-нджелгу
разпугать - ла-рчигу
разпялить - малня-кылгу
разсказъ - катка-лбыдимы
разсказать - ка-ткылгу, че-ннимбыгу
разсказать толкомъ - па-ткылгу
разслабить - сла-бканъ ме-гу
разсматривать - конне-мма-ннембыгу, ма-стерынгъ ма-ннембыгу
разсмотрöть - ма-стерынгъ ма-ннембыгу
разсохнуться - чаге-нджигу
расспрашивать - со-гончагу
разсöивать зерна - малча-джигу
разсöиваться - ю-рле ма-льчигу
разсöяться - ё-ргу, ва-скватку
разсöяться (дымъ) - каш ко-й ю-румгу
разсöяться (о людяхъ) - мал ква-нгу
разставить - малмачко-льджигу
разсудительность - тэ-йербыдимы
разсучить (нитки) - могне- че-бсыгу
разсыпать - камдечигу
разсыпаться - камде-чигу
разсыпчатый - че-имба
растаять - чу-гу, чулечугу
разтерзать - ма-лнышкы-ргу
расти - о-рынгу
растлöвать - пана-лгу, чу-къ а-мбатъ
растлить - пана-лгу
растолковать - тэ-йзе толкова-имгу [исправлено из растолкова-имгу], толкова-имгу
растрепанный - ка-рланъ е-нгъ, варса-лжимбыди
растрепать - варса-лджигу
растянуться - чу-мбынка-нгыльджигу
разчесывать - католеда-дыргу
ратовать - те-ттенбыгу
рвенiе - путё-мъ кыгыде-
ребенокъ (дöтское назв[анiе]) - пуба-
ребенокъ женск[ого полу] - не-йгомъ
ребенокъ мужеск[ого полу] - тебетомъ
ребенокъ общее назв[анiе] - са-дыка кыба- го-мъ
ребра (чресла) подпоясать - пы-ргынъ кю-ндогу
ребро - ке-дыллы-
ребята - кыба- ко-лау, ребята-у
ребятишки - кыба-мола-[ зачеркнуто], ребятишки
ребятушки - кыба- гуламби [исправлено из гуламбiу], ребя-тамби [исправлено из ребя-тамбiу]
ревöть - па-ркугу, ла-нгыску
ревнитель - стара-йчикудъ
ревнительный - стара-йчимбыди
ревновать (жену) - ке-льджигу
рöзать - ма-чьгу
рöзкiй - ча-лынгъ
рöка - ква-й
рöка прошла - ква-йенъ ква-ненбатъ
ремень - чи-нгъ, ю-нь
рöпей - пу-дырганъ
рöсница - се-йну-ндъ
рöчка - кё-
ржавöть - сы-рбагу
ржавчина - сы-рбадимы
ржать - ло-гонбыгу
робöть - кычва-тку
робкiй - ла-рымбыди
робкiй челов[öкъ] - муга-й ко-мъ
ровъ - ро-въ, кана-ва
ровесникъ годами - дру-къ те-лынба-
ровесники ростомъ - ке-ндзяги
ровный - та-дынъ е-нгъ, о-кыръ са-ньенъ
ровный о дорого - ура-нь
рога животнаго - а-мдъ
рога у вилъ - ча-ра
рогатина медвöжья - су-ри пе-рчиса гво-зъ
рогатка деревян[ная] - ча-ка
рогатый - а-мди
родившая, родильница - инма-ты ко-мындатъ
родина - наче-нъ те-лымба
родители - э-стъ а-утъ
родитель - эзе-у
родить - ко-гу
родить о животныхъ - ко-гу
родиться - те-лынбыгу
родникъ - тэ-ръ
родной - те-лынбыди
родственникъ - родня-у
рождать - ко-ку
рожокъ для ребенка - розо-къ
ропотъ - кво-дымбыдимы
роптать - кво-дыгу [исправлено из кво-дымбыгу]
роса - ка-дамба, ча-бтъ, ча-бтыпы-нгылымынды
ростомъ - пыргы-тъ, пи-рытъ
ротъ - а-нгъ
рубашка - ка-поргъ
рубить - па-четугу
ругатель - ты-мбыди ко-мъ
ругательство - ты-мбыдимы
ругать - ты-гу
ружейный курокъ - тю-льсенъ сакку
ружье - тульсэ-, тюльсэ-
ружье двуствольное - сыдство-лка
рука - уть
рукавъ - кола-нъ [исправлено из ко-ланъ]
рукавицы - но-пъ
руль - кормо-вой ла-пъ
румяный - ры-жай

русская женщ[ина] - каза-гне-йгомъ
русская земля - каза-гынъ чво-чь
русскiе люди - каза-гла
ручей - ручья-къ
ручей материчный - кыгэ-
рыба - кво-лъ
рыбакъ - кво-лысба
рыбка - кво-лымби
рыданiе - нега-ттынъ
рыдать - чу рогу не-гатчигу
рыжiй - ры-жай
рыло - а-нгъ
рыситься о животн[омъ] - нё-ргу
рысь звöрь - ры-сь
рыть землю - католеда-дыргу
рыхлый - ка-гылбыди
рюмка - ча-рга
рябой - рябо-й го-мъ
рябчикъ - пэте
рядъ, ряды - ря-дъ


съ - зе- (послö существительного])
съ издавна - кундо-кындо э-зынъ
сабля, мечь - тэта
сажа - ка-ндъ
сало - ё-ръ
сальное пятно - са-лазе ко-золомбанъ
сальный - са-лай [исправлено из сала-й]
самъ - о-ндъ
самъ себö - о-нде пире-гантъ
самъ себя - о-нде пи-ремтъ
самовидецъ - о-ндъ
ко-нджиркудъ, ку-дъ о-ндъ ко-нджирбанъ
сани - са-ни, ка-джи
сапоги - тапо-къ
сбöжать - каре-куро-лгу
сберечь - береги-мбыгу
сбирать ягоды - ква-дыгу
сбираться идти - ю-бычигу
сближаться - о-кырмынтъ ла-квангу, та-кылгу


