ад=а́д
алчущий=кытынди а́воргу
алый=ня́ргенгь
амбар=кле́в
ангел=а́нгелен
ангельский=а́нгельди
аркать натравлять науськивать=кы́рымбыгу
аршин=арсы́н
афонасий=панаса́
бабка=нима́
бабочка=ла́мбрека
баран=коне́рка
батюшка=а́ча́
бдение=а́нгу ча́нгван
бегающий=ко́рти
бегом бежать=о́рсе куро́лгу
бегущий=куро́лпыдимы
беда=беда́
бедный=нужнай, бе́днай
бедро=пе́л
бежать бегать=куро́лгу
без=га́лк (посло сущ[ествительного])
без малого столько-то=супта́й
без оглядки=ма́ннембыгунчалк [ исправлено из ма́ннембыгун́ча́лкъ]
без отдыха=а́с о́мдыку, о́тдыкангалк
без платы=да́ром
без принуждения=о́нде во́леут
без просыпа=а́с кы́льчикван
без сомнения=безсумле́нья
без успеха=т<о́>кды (т<а->кды?) а́с ми́дымбать
без утайки=та́умбыгалк
без чего нельзя жить=э́лгусан аз е́м
без числа=тэ́йгалкъ, та́гола [ строка зачеркнута]
без числа=тэ́йгалкъ, ка́ндыбынг
безводный=ё́тгыди
безделье=никако́й рабо́тан ча́нгван
бездельник=безде́льник
бездна=ко́рын е́нгь кра́льди нэ́й ча́нгван
беззаконно=а́с зако́ннан
беззубый=те́угыди
безначальный=у́гыгыди
безногий=то́пгыди
безносый=пу́чигыди
безответный=безотве́тнай
безропотно=дово́льнан э́зыгу
безрукий=у́тгыди безумный ́тэ́йгыди
беленый=бели́мбыди
беленький=че́галанд
белокурый=па́тнол
белый=те́гь, те́ган
берег=ке́нбар
берегись=а́рангурок
береза=кюэ́
беременный животное=има́дырбан
беременный человек=на́нҗе не́йгом
береста=твэ́
берестяное ведро=ко́рынҗека
берестяной=твэ́й
беречь=береги́мбыгу
беречь=караву́мбыгу
беречься=а́рангыргу
беречься=пи́ремт караву́мбыгу [строка зачеркнута]
бери=и́г<и>ты [строка зачеркнута]
беседовать=келеда́дыргу
беситься=мана́мбыгу
бесконечный=та́быгыди
бесовский=ло́зынзиди
бесплодный=чо́быргалк
беспокоить=безпоко́имгу
беспокоиться=[безпоко́]итчигу
беспрепятственно=ку́дын нэ́й а́с меса́имба
беспрестанно=а́с у́тыркван
бессильный=о́румгыди
бесславить=а́с а́ндугу
бессловесный=ы́эчьгыди
бессмертие=безсме́ртыгат
бессмертный=сме́ртгыди безсовестно ́совестн<ан>га́лк
бессонница=а́с ко́ндонанг
бессонный=а́нгуди безтелесный ́ва́тьитча́кванди, ва́тьигыди
бесценный=ме́ртегыди
бесчестие=стра́м
бесчестить=безче́стимгу
бешеный=мана́мбыди [исправлено из ма́намбыди]
бисер=пюссе́й
битый=ква́тпыди
бить=ква́тгу
биться драться=дра́кыса́тчигу
биться о человеке больном=ты́ргымбыгу
бич кнут=ка́рсын
благоволить=а́рынь ко́мть сво́мы кы́гыгу
благодарить=благодари́мбыгу
благодатный=благода́тной
благодать=благода́ть
благородный=сво́ поро́дандо ко́м<ъ>
благоспеятися=сво́н ме́гугу
благоухание=путё́м сво́ а́ет
благочестивый=благочести́вой
благочинно=поря́дкагын
блаженство=а́рын векогын сво́ э́лан
блевать=тю́дугу
блевотина=тю́дунбыдимы
бледнолицый=вандо́гент ка́внэ́й ча́нгван
бледный=те́гын
блекнуть=тегенча́ннынбыгу
блестеть=чо́лгонбыгу
блестеть о зарнице=по́рымбыгу
блестящий=чо́лгонбыди
блеять=мё́генбыгу
ближе=чардзе́калаг
ближний=чардзе́каги
близко=чардзе́кан
близко о времени=а́с кундо́кынъ, чардзе́кан
блин=ала́ндя, блин
блистать=те́лыргу
блоха=сы́гтэ
блуд=кю́дчидимы
блудник=бля́дь, кюдче́ди тебе́ком
блудница=кюдче́ди не́йгом
блюдо=блю́до
бобер=пучо́
бобровый=пучо́нпоби
бог=Но́м
богатеть=ко́игу
богатить=ко́игуле мету
богато=ко́умбыле
богатство=ко́умбыдимы богатство ума, богатство премудр[ости]́ ко́умбыдильтэ́йд
богатый=коумбыди, зачеркнуто:] ко́умбыти
боги=нула
богиня=не́йно́м
богомольный=Номт о́мтынди [комъ]
богомудрствовать=Но́мде тэ́йербыгу
богородица=богородиса
богу дар=но́мт ко́за
бодать бодаться=а́мтыгу
бодриться=со́гидде
бодрствовать=а́с ко́ндолҗенҗигу
божба=не́вончимбыди
божественный=Ну́н
божий=ну́н
божий дар=Нун да́р<ъ1>
божиться=не́вончигу
божия матерь=Нун́ А́ут
бок=кенҗаръ, по́к
болезнь=месала́нъен
болезнь не к смерти=мессала́н ен а́с куссо́ди
болото=ка́льҗъзан
болтать языком=болта́йчигу
больнее=кё́зынлаг
больно=кё́зынг
больной=месала́й
большая вода=ва́рг ё́т
большая дорога=ва́рг ва́т
больше=ва́ргылаг
больше нежели=танна́н ко́чи манна́н та́нака енг
большой=ва́ргь е́нгь
боров животное=сыбындя́
борода=у́мде
борозда=кылба́
бороться=ора́лгу
босиком=пё́угалк
босой=нельде́нто́пын е́нг
ботинки=боти́нка
бочка=по́чка
боязнь=э́лл
бояться=ла́рымбыгу
бранить=ты́гу
браниться=ты́ндугу, кво́дымбыгу
брань хула=ты́мба
брат большой=ага́у
брат в разговоре звательный падеж=бра́т
брат меньший=тимня́у
брат общее название=тимня́у, тимня́ла
братолюбивый=ве́сь свыо́рбыкунди братскш ́тимня́ум
брать=и–гу
бревно=бро́вна
бредить во сне=ко́ндолгу <а́й> че́нчигу
бремя=са́тчимен
бренчать=ке́ттелбыгу бровь́ се́йнъ́о́нд
бродить в воде=ю́ткын <да́ >дыргу
бродни=бро́ден
броня=кво́зи по́рк
бросать невод в воду=по́тку
бросить лукнуть=ча́җигу
бросить прочь=точа́җигу [ исправлено из тотя́жгу]
бросить якорь=я́корь ча́җигу
броситься=па́ктыргу
брусок=сыльҗиса́пю
брызгать=ва́скыргу
брызгать ртом=пудолгу
брюхан=варна́тжи ко́мъ, ю́рсей, ка́бырледи
брюхо=на́нчь
брюшина=по́унъ́о́л
бугор холм=ма́кка
будто=бу́дто што́
будущая жизнь=а́рынг ве́к
будущий=няндо́ни, нянней
будущий год=тита́ви по́д
буйный=те́ттенбыди
букашка=чу́к
булавка=була́вка
бунт=пу́нт
бурный ветер=си́льнай мергыза́н
бурундук=се́пка
буря=пого́да
буря на море=мо́рянсе́рбат
буря на реке=ква́йенсе́рбат
бусы=ва́рг пюссе́й
бывать=э́зыгу, э́зембыгу
бык=бы́ка
быстрый=чандча́женъ, кю́<вв> [зачеркнуто]
бытие=э́<л>ан
быть надменным=ва́ргыльҗигу
быть покорным=поко́рнан э́зыгу, ю́нгольҗигу
быть трезвым=а́с ю́тку
в глазу=се́йгын
в другой раз=сы́дымҗ<еч>чи, а́урынг
в нем=та́быгын
в нем о человеке=перге́ гын
в себе=о́ндегын
в середине=сыдгоде́римы
в том=на́угын
в шапке=ё́къзе́е
в этом месте=тындга́
валек=ча́чь
валяться=пю́нгульҗигу
вареный=по́тпыдимы
варить=по́тку, э́ттергу
вбитый=кэ́ттелбыди
вбить=кэ́ттелгу
вверить=дове́римгу
вверх ногами=сугульча́
вверх реки=та́мы
вверху=и́ннен
ввести в убыток=убы́тканзе та́ннен
ввести вводить=тоа́льҗигу
вдали=кундо́кын е́нг
вдвинуть=чо́голҗигу
вдова=серы́м па́
вдоль=чу́мбын
вдруг=туру́къ, па́б
везде=везде́
велелепный=катку́ а́с мо́жнан е́нг
велеть=кура́льҗигу
великий=ва́рг
великий бог=Ва́ргно́м
величайший ум=путё́мъ́ ва́рг тэ́й
величать=велича́имгу
величаться богатством=ва́ргыльҗигу
величие=ва́ргычга
величие божие=Ва́ргычга Нум
венок=вено́ка
веревка=пенько́ва
веретено=кю́т вбрить́ ве́римгу
верный=ве́рнай вбровать ́ве́рытынбыгу
вертеть вертеться=ко́ирыгу
вертеться=ко́йватгу
верткий=вё́рткай е́нг
верхушка=пальчо́бар
вершина дерева=няргыно́лъ, поно́л
вершина дерева=ню́к
веселиться=весела́нненгу
веселый=весё́лай
весить=ва́тчигу
весло=ла́п
весна=ё́тат
весновать=та́умгу
вести водить=та́льҗигу
вести жизнь=э́д<от>деква́ддыгу
весть=весте́й
весть дать=ве́стим ми́дыгу
весьма=кандыбынгъ, путё́м
ветер=мерга́н
ветер бурный=ва́рг ме́ргын
ветер воет=чу́ран
ветер возметает=качку́ ча́жен
ветер гнет дерево=ме́ркма́ныкот
ветер начал дуть=ме́ргеле ю́бырзан
ветер подхватил и понес=ме́рг ква́тчимба а́й
ветер попутный=мого́л ме́рг
ветер противный=кве́се ме́рг
ветер развевает=леле́етымбат
ветер ревет=ла́нгыску
ветер с востока=та́мынди ме́рган
ветер с запада=та́нгынди ме́рган
ветер с севера=а́ургын ме́рган
ветер с юга=съюта ме́рган
ветер свистит=со́мнымбыгу
ветка=кыба́ мо́ла
ветру=э́чьжигу
вечер=Но́м ю́демба
вечер=ю́демы
вечерний=ю́ди
вечером=ю́демыган
вешалка=и́дыгу
взамен=нанго́птон
взаперти=кэ́ттенбыди
взбалмошный=мана́мбыди го́ м
взбежать=куро́лгу
взвести курок ружья=са́ ккумо́ мдальҗигу
взглянуть=манҗе́чигу
взгромоздить=ва́ргын пы́ргын те́льҗигу
вздохнуть=кво́яргу
взлесть=сы́голгу
взлететь=и́ннеква́нгу
взмутить=нынго́льҗимбыгу
взятка=взя́тка
взять=и́гу
взять в ум=тэ́йрбыгу
взяться за дело=ора́лгу
взяться ухватиться=и́гдыгу
видеть=ко́нҗиргу
видеть во сне=кюде́птембыгу
вилка=пила́йгвоз
вилы=пила́йпо́
вина=вина́
вино=ара́нка
виноватый=винова́нан е́нг
винт=ви́нт
висеть=ы́дыгу
висок=нярымо́
вить веревку=па́нгылгу
вить гнездо=пё́т меледа́дыргу
вколотить=ка́ттылгу
вкопанный=па́кыльдимы
вкорениться=ко́нҗ<ить> э́зыгу
вкусный=вку́шнай
владеть=владе́имгу
влезть во что=сы́рчигу
вливаться течь=нё́реҗелеча́жигу
вложить=пе́нбыгу
вменить зачесть=о́мдальҗигу
вместе=о́кыръ́мыгы́н
вместе в ряд=кечё́льдчь
вместе с собою=о́кырмыгы́н пи́ремтзе, ондызе
вместе с тем=о́кырмыгы́н та́узе
вместить в себя=па́дчигу
вместить может=мо́жот па́дчан
вместо=заме́ста
внести=то́тку
внести в книгу=на́гыргу
внешний=поне́блекат
вниз реки=танны́ вникнуть́ тэ́йербыгу
внизу=илле́ймы
вновь снова=са́ндын
внук=и́ндъи́
внутренний=сю́ндзеней блекат
внутренность=сю́ндзенейбека́т
внутри=сю́ндзенен
внучка=и́ндъи́
вовсе=ме́льдчь
вода=ё́т
вода большая=ва́рг ё́т
вода малая=кыба́ ё́т
вода прибывать=ме́чигу, мё́дзимбыгу
вода убывать=ку́зорымбыгу, ку́зорлеча́жигу
водвориться=ны́нд э́лгу
водить=та́льҗигу
водить кругом=пю́ронг ко́ирыгу
водяная заводь=пальчо́
водянка болезнь=ю́т ча́жент
водяной=ё́ди
воевать=те́ттенбыгу, мю́т< ч>а́жигу
вожжи=вазза́
возбранить=а́с кура́льҗигу
возбуждать=сы́дыгу
возбуждаться=сы́дычигу
возвестить=пакталгу, ве́стим ю́дыгу
возвратить=могне́ ми́гу
воздержание=терпи́мбыдымы, пи́ремт у́турумбыдимы
воздерживаться=терпи́мгу, у́турымбыгу
воздух=кво́й, по́ра [зачеркнуто]
воздушный=кво́йзю
возле=ко́йгынъ, кё́югей
возложить=пе́нгу
возлюбленный=свыо́рынди
возрадоваться=а́нталбыгу
возрастить=о́рынчугу
война=война́
войско=мю́т
войти=се́ргу
вокруг=пю́рон е́нг
волк=тюмбне́
волна=валра́н
волноваться=ва́лугу, ва́лыргу
волны поднялись=ва́лырнан
волос=та́ръ, о́пт
волос на голове=о́лынта́ръ, о́лыно́пте
волосогрыжица=о́птылчук
волочить=ютолбыгу [строка зачеркнута\
волочить по земле=чво́чегын ю́голгу
вольно=во́льнан е́нг
воля=во́ля, тэ́йел о́не
вон поди=тё́к ва́нк
воображение=тэ́й
вообразить=тэ́йрбыгу
вооружаться=войнан гото́витчугу
вооружиться=тэ́гам и́гу
вопросить=со́гончигу
вор=твэ́лъ, твы́олбер
воробей=синдя́ка
воровать=твы́олгу
воровской=твы́олбыдимы
ворожить=чво́жиетыгу
ворон=куля́
ворона=кво́ре
вороной=ка́регент
ворота=ма́да
воротить кого=могне́ ба́ралгу
воротиться=могне́ ба́ралгу
ворчать=кво́дымбыгу
воскресить=иле́етымбыгу
воспитать=оголчо́лҗигу
восставать=ва́зыгу
восставить=ны́льҗигу, че́тчигу
восстановлять=ва́тчигу
восток=чё́лынд а́жармо
восторжествовать=нульдте́лдчигу, пра́здничугу
восточный=та́мынди
восхищаться=путём а́нталбыгу
вот=та́у
вот я тебе дам=ма́н те́гент ме́лебс
воткнуть во что=сы́кыгу
воткнуть на палку=по́ндын понҗо́льҗигу
воткнуть на что=понҗо́льҗигу
воцариться=а́мдикугле ме́гугу, а́мдикугле о́мдыгу, а́мдикугле о́мдальҗигу
вошь=у́нычь
впереди=ня́ннен
впредь=ня́нненг
враг=а́с дру́к
враждовать=а́с дру́ган э́гу
врать=седе́птыгу
вред для здоровья=кё́зендимы
вредить повредить=вреди́мгу
вредный человек=во́риго́м
врожденно=те́лымб.
врозь=сытова́с
все равно=всё́ равно́
всегда=ме́льдчь [зачеркнуто], завсегда́
всегда быть=завсегда́ э́гу
вседелающий=ве́сьме́җерынди, ве́сьме́гумбыди
всем нравящийся=нра́винэ́стымбыди
вскочить=па́ктыргу
вскочить куда=вассе́дигу
вскочить со стула=па́ктыргу [ исправлено из па́ктымбыгу]
вслед=о́кыр ва́т<и>он
всплыть=ка́мбальҗигу
вспотеть=нельдчигу́
вставить=мачко́льҗигу
встать на моль=ча́вын чатымбыгу
встать о реке=канде́зимгу
встать с постели=ва́зыгу
встретиться=ко́гычигу
всякий=ка́жнай
всё=ве́сь, ве́сь е́нг
вход=т́iунт се́ргу
вчера=те́лдел вшивый ́у́нчирбан
въехать=ква́нгу
выбежать=тикуро́лгу выбирать рыбу из сетей́ ня́кыледа́дыргу
выблядок=тыбыга́т ко́мбыди
выбрасывать тяжесть=конне́ ма́ктыгу
выбрать=выбира́имгу
выбросить=иллеча́жигу
выбросить на берег=конне́ пальҗо́льҗигу
вывалиться=пы́кыльчигу
вывернуть=могне́ ба́лгылгу
вывести=поне́ ча́җигу
вывести вон=токва́ндыгу
вывести цыплят=ко́гу
выворотить=а́ублекат пи́гольҗигу
вывострить=се́лгу
выгладить=гла́дингу
выгнать=поне́ ка́ннингу
выдать=теми́гу
выдвинуть=точаго́льҗигу
выдра=те́т
выехать=понеква́нгу
вызвать=квэ́ргу
вызваться исправлено из вызвать чрез=квэро́льҗигу выздороветь́ сво́ э́зембыгу
выиграть=и́гу
выйти=поне́ ча́җигу
выйти за муж=те́быгу
выкидыш=ку́мбыди те́лымбан
выколоть=мё́җежигу
выколупать=то́гатолгу
выкопать=па́катыгу
выкормить=а́бстугу
выкупивший=та́умкунди ко́м
выкупить=та́угу
вылезть=точа́нҗигу
вылечить=э́стегу, легчи́мгу
вылить=ве́сь га́мҗигу
выложить=и́нневентпе́нгу
вымазать=ма́зимгу
вымарать=ко́золгу
вымараться=ко́золчигу
вымерять глубину=ма́льҗургу
вымести=чо́балгу
вымыть=мё́золгу
вымыть ружье=тю́льсэ сю́ннетмё́золчигу
вынуть=теи́гу
вынуть якорь=я́корь че́тчигу
выпадает снег=сы́рым пе́нбат
выпасть=пы́кыльчигу, пы́нгылгу
выплыть=ка́мбальҗигу
выплюнуть=свё́зыгу
выпросить=со́гончагу [зачеркнуто], ма́дыргу выпрямить́ та́дынкаро́льҗигу
выпустить=ю́дыгу
выразить=ка́ткылгу
вырасти=о́рынгу
вырастить=о́ры<м>чигу
вырвать из земли=конҗо́лтола́кчигу
вырваться=манчо́лгу
вырезать=ма́челгу
выронить=илле́ а́с тыгу
выручить=кундере́м и́гу
высекать огонь=ва́скыргу
высидеть цыплят=ко́гу
высказать=ча́рыгу
выскочить=ча́рогу [исправлено //зча́рыгу]
выслать=тею́дыгу
выслужиться=угоди́мгу
высокий=пы́р е́нг
высокий человек=пы́р го́м
высота=пы́ргын е́нг
высохнуть=ча́гынбыгу
выставить=поне́ мачко́льҗигу
выстрелить ружьем=папе́чжильгу
выстрогать=ко́дгаингу
высунуть=па́ргылбыгу
высушить=чаго́етыгу, ча́гынбыгу
вытаскивать сеть=ю́голгу
вытащить=ю́гулгу
вытащить лодку=конне́ ю́гулгу
вытеребить=мизе́лгу
вытерпеть=терпи́мгу
выткнуть=пе́рельҗигу вытолкать́поненямбо́зигу
выточить=се́лгу выть
выть волку=кво́дынбыгу
выть человеку=чу́рогу
выхватить=ква́тчингу, па́ктыле ча́быгу
выход=тГунт ча́нҗигу
вычистить=нё́рбалгу
вычистить ружье=сю́ннет нё́рбалгу
выше=пы́ргылаг
вышний=нунсинче́гой
выяснеть=по́рабчимбыгу
вьюга=пу́рга, мерги́ пальчо́
вьюга затихла=у́тыргу
вязать=свырме́нчигу
вязаться=вяза́тсанэ́зыгу
вянуть=иллепы́нголгу Г
вёдро=сво́ Но́м
галка=тыза́бала
гаснуть=ка́птымгу
гвоздь деревянный=ти́б
гвоздь железный=гво́зильтиб
где=ка́йгынъ, куте́н
где-нибудь=кудче́нь э́нейбы
гладкий=гла́дкш
глаз=се́й
глина=чу́
глодать=ту́толеда́дыргу
глотать=а́мгу
глубина=ко́рынгь
глубокий=ко́рын е́нгь
глупость=глу́пасть
глупый человек=дура́гынен го́мъ, во́рынен го́мъ, тэ́йд ча́нгван го́мъ, глу́пай
глухарь птица=са́нг
глухой=котыди
глухой о звуке=сю́нчейбипужимы
глыбоватая земля=ка́нкалан е́нг
гнать в погоню=ка́льҗругу
гнать догонять=та́нгынбыгу
гнев=те́мба, сёндзене́й во́дырсан [зачеркнуто]
гнев божий=Ну́н те́мба
гневаться=те́мбыгу, кво́дымбыгу
гнездо=пя́т
гниение=тэ́мбыдимы
гнилой=тэ́мбыди
гнилушка для курева=сырго́й по́
гниль дерева=тэ́мбыдимы
гнить=тэ́леча́жигу
гноевая рана=тэ́бырбан
гной=тэ́
гнусить=кё́ннембыгу
гнусный=аво́й го́м
гнуть=каро́льҗигу
гнушаться=ас свыо́ргу, токуро́лгу
говорить=че́нчигу
год=по́д
годы младенческие=кыба́ э́зын
годы юношеские=куса́кын одчеде́й э́зын
голень=пулзе́й [зачеркнуто], ку́нгыл
голова=о́л
головня=по́ндаб
голод=а́вгалк
голодный=кво́затъ, аза́урбат
гололедица=го́лай ка́ндыкатъ, го́лай улго́
голос=го́лос
голос громкий=гро́мканго́лос
голос толстый=ва́рг го́лос
голос тоненький=чо́зкин го́лос
голубь=го́луп
голый=го́лай, а́с че́мбытбыди
гора=кэ', танба́р
горбатый=горбун
гордость от богатства=ко́уран
гордость упрямство=ва́ргыльчимбыди
гордый=чи́умбыди
горе=го́ря
горевать=таску йчигу
гореть=по́рымбыгу
гореть духом к богу=кво́йунзе Но́мды кы́гугу
горечь=па́риндимы, го́речь
горло=со́й, куко́й горница́ ма́тъ́го́рниса
горностай=ку́р
город=ква́чь
городить=та́ттыгу
горсть=о́ра
гортань=куко́й
горшок=тюнака́
горький=па́риндимы
горячий=пе́рчан
горячка болезнь=не́льдзигумбан
господин=няче́йгатъ,гаспади́н
господина жена=гаспади́ннэ́т
господствовать=гаспади́нан э́гу
господь=госпо́дь
гостить=гости́тчигу
гость=го́сть, чадзе́и го́м
готовиться=ква́нҗигу
грабли=гра́бля
град=лага́й соронҗо́н сейла́
грамотный=на́гырымты́ннымбыди
граница=ко́рымбыдимы
грач=ты́й кво́ре
гребень=те́псен
гребь весло=мо́голап
гремет=ыэ́чьжигу
гремет громко=ва́ргынь ыэ́чьжигу
грести веслом=тукугу
грести гребью=мо́голапычигу
греть=пё́тчимбыгу
грива=пу́
гроб=сэ ́
грозить пальцем=му ннымпа́челгу
грозить словесно=ы́эчьзе па́челбыгу
гром=Но́м ё́җен
громкий=колосэ́
громко=о́рсе́е́нг
громко говорить=гро́мкан че́нчигу
громко кричать=гро́мкан ла́нгыску
громче=о́рселагь
грудь=кы́лынол
грудь женская=не́псыт
груз=гру́з
грузный=татымбыле
грустить=таску́йчигу
грустно=таску́лян
грустный=а́нталгыди
грызть зубами=тутоледа́дыргу
грызть орехи=пуча́лгу
грязь=ны́ска, паска́
губа верхняя=инне́йтыу
губа нижняя=илле́йтыу
губитель=ко́м ке́ттеле ча́жикуд
губить=катынбыгу
гудение дудки=ыэ́чьжимбыдимы
гусли=гу́сли
густой=густо́й е́нг
гусь=тве́го
да=но́
давай ну-ка=ча́, чатон
давать=ми́кугу, миту
давеча=ты́нъде
давно=кундо́кын э́зен
далекий дальний=кундо́кын е́нг
далеко=чу мбын
дальше=кундо́клагь
дар душевный=душаги о́ром
даром=да́ром
дать=миту
дать в долг=колча́ндмигу
дать знать=ве́стим ми́дыгу
дверная скоба=ма́данква́с
дверной порог=ма́дандо́б
дверной створ=ма́данко́ччер
дверь=ма́да
двигать=ча́гыргу, ю́голгу
двигаться=ча́голҗигу, лаго́льдчигу
движимый=ю́голбыди
двоедушный=сы́д тэ́йде табынна́н е́нг
двойной=сыдню́рти
двор=воро́тан сю́нчь
двор скотный=ворота́
двуязычный=сы́дымынды се́тчан
девица=одчеде́й кыба́ не́йгом
девический девичий=де́пкагый
девка=де́пка
девочка=кыба́ не́йгом
деготь=дё́гтиса́
дед=авна́ска
делатель=ме́мкунди
делать=ме́гу, ме́кугу, меледа́дыргу
делаться лучим=сво́н метугу
делаться темным=лыба́н метугу
дело=те́лан
день=те́лд
день настал=Но́м те́лынба
день чрез=тита́ви те́лд
деньги=ко́мде
деньги медные=меднай ко́мде
деньги серебряные=моне́тан ко́мде
деревня=кыра́
дерево=ня́ргъ, по́
дерево где подарки лозу=по́
дерево гнет ветер=ме́рк мы́ныкот
дерево гниет=тэ́леча́жен
дерево падает=пу́нгыллеча́жен
дерево падает лист=пы́нгыллеча́жен
дерево распускается=ча́быторыблеча́жен
дерево растет=о́роблеча́жен
дерево сохнет=ча́нглеча́жен
дерево срубить=пача́лгу
дерево увядает=те́гын ча́нҗледа́дрыт
дерево цветет=те́ллеча́жен
держать держаться=ора́лбыгу
держать иметь=ва́ргу
дерзать=насме́литчигу, сме́лан э́зыгу
десна=те́вуте, по́ун тибито́у
дети=ийма́тлау
дети проклятия=прокля́тай ийма́тла, прокля́тай приро́д
деточки=ийма́тламб|у
детский=кыба́гой
детушки=ийма́тламб|у
дешевый=чо́сыван е́нг
дивный=ти́вай
дикие животные=ма́тьинсу́рула
для кого=дат[ельный] падеж
для меня=ме́ген
для себя=пи́регант дневной ́те́лынд
дно=ы́лд
до=на́уга (послб сущест[вительного])
до которых пор докуда=ку́нчан
до о времени=ча́н (послб сущест[вительного])
до сего времени=та́у вре́мянчан
до тех пор=наса́кын э́зын
добежать=куро́лгу
добренький=сво́гула́нд
добро=сво́
доброделание=доброде́тель
добродетель=доброде́тель
добродетельный=сво́ми́кунди, доброде́тельнай
добрый человек=сво́гом
добыть зверя=ква́тку
довезти=ме́тергу
догадаться=ко́стыгу
догнать=ме́тыгу
догонять=та́нгынбыгу, кату
доехать=тюлеми́дымбыгу
дождаться=а́дыльчигу
дождь=со́ръ, соро́нг
дожидать=а́дыгу
доить=па́ргылгу
дойти=ме́тыгу
доказательство=доказа́тельства
доказывать=докази́мгу
долг=ко́лдча
долг=на́у, ка́й до́лжнан ме́гу
долгий=чу́мбын е́нг
долго=ку́ндын е́нгъ, ко́ндынгь
долговременный=ку́ндынвре́мяннай
долгоносый=чу́мбыпу́чиноли
долготерпеливый=ку́ндын<гъ> терпи́мбыди
должник=ко́лдчези ко́м
долина=ва́ргсо́й
долить=та́ргу
доля часть=ча́дол
дом=ма́т
домашний=ма́ткый
домашний скот=ма́ткыйсу́рула
домостроитель=ма́тынстро́имкунди ко́м
допрашивать=дапроси́мгу
допрос=дапро́с
дорога=ва́т
дорогой=мерсе́й е́нг
досадитель=досади́мкунди ко́м
досадить=досади́мгу
досадно=доса́днанг
доска=ле́м
достать=и́гу
достигнуть=ме́тергу, ме́тигу
достигнуть=нынга́ ми́дыгу, ми ́дыгу
досуг=досу́к
досыта=ка́пучиле
доха=доха́
дочь=не́у
драгоценность=даргосе́ннан е́нг
драгоценный камень=даргосе́ннай ка́мень
дразнить=нея́льҗимбыгу
драка=дра́ка
драться=дракыса́тчигу
драться=те́тенбыгу
древние грехи=и́ри гре́гла
древний=и́ри
дремать=ко́ндольҗе́нҗигу [ исправлено из ко́ндолченчигу]
дробовик=дробови́к
дробь=дро́п
дрова=палё́на
дровни=дро́вен
дрожать=ты́ргымбыгу
друг=дру́к
другой=а́рымъ, а́внетъ, а́рынгь
дружелюбный=дру́жнан э́лыкунди
дружно=дру́къ, дру́жнан
дружными быть=дру́жнан э́зыгу
дуга=дуга́
дудит=са́нҗиргу
дудка из тростника=ни́дерзучисан
дуло ружья=тюльсенпу́чь
дума=тэ́й
думать=тэ́йрбыгу
дунуть дуть=пу́голгу
дурак=дура́к
дух=кво́йл [исправлено из кво́йолъ], кво́й, кво́йу
духовный=кво́йзиди
душа=душа́у
душистый=а́етезой
душить=сы́кдыгу
дым=кашко́у
дымить=кашко́льҗигу
дыра=па́гыр
дырявый=па́гырлазый
дышать=кво́яргу
дядя=елдча́у
дятел=чи́мҗе
едва=насу́ль
едва едва не=е́рын а́съ, кыба́н а́с
еденный=абледа́дыртымы
единодушно=окырмыдым э́мба, окырдуша́нтзе
елец=ква́нт
ель ёлка=ню́лк
если=е́сли
если бы=е́сликабы
естественный=приро́днай
естество=приро́д
есть=а́мгу
есть обедать ужинать=а́воргу
ехать=ча́җигу
ехать в лодке=па́льдчигу
ехать вскачь=па́ктырнан ча́җигу
ехать по воде=кю́н мого́л
ехать рысью=га́зын ча́җигу
ехать шагом=кво́жиндан ча́җигу
еще=та́р [зачеркнуто], а́й, а́йст
жадничать=ты́дымбыгу
жаждущий=ю́дыргу кыгы́н
жалеть=жале́имбыгу
жалить=па́кылгу
жалкий=жа́лкай е́нг
жало у змеи=у́гот
жалоба=ты́бъ, кайно́ о́мдтыбе
жалобно=омдле́ ва́нба
жаловаться=о́мдытгу
жаль=жа́лка
жарить=жа́рингу
жаркий=пё́тпа
жарко=пё́тпан е́нг
жатва=жа́тва, абсо́т<ым>ма́чимбыдимы (<ьли>?)
жать сжимать=ы́пкалгу
жать хлеб=абсо́тима́ч<чи>гу
ждать=а́дольҗигу [зачеркнуто], а́дыгу
жевать=ту́ттогу
желание=кыгытэ́
желание плотское=ва́тизиди кыгыде́
желать=кы́гугу
железо=гво́з
желтый=па́дын е́нг
желчь=па́д
жена=пая́у, эмо́у
женатый=не́тымбыди
жениться=не́тыку
жених=жени́х
женские груди=не́псыт
женский=не́йку́м
жердь=же́рде
жеребенок женского полу=сю́мака
жеребенок мужского полу=ко́рока
жеребец=ко́р
жертва лозу=ко́за
жечь=пё́тчимбыгу
живительный=иле́етикод
живой=э́лынди
живот брюхо=на́нчь
живот внутри=си́димыдыт
животворящий=иле́ети ку́жинди
животное=су́рум
живущий=э́лыкунди
жид=жи ́д
жидкой=зи́дкай енг
жизнь=э́лытет
жизнь хорошая=сво́элгу́
жизнь худая=а́вой элгу
жила=ки́ун пе́нг
жилетка=камзо́л
жилище=э́лыан
жир=ё́р
жир рыбий=кво́лын ё́р
жиреть=ка́бырлеча́жигу
жирный=ю́рсей, ка́бырди
житель=наэ́тцигом
жить=э́лгу
жужжать=кы́нгырымбыгу
журавль=кара́
журчать ручеек=кю́мныгу, со́мнымбыгу
за водою=ё́тынно
за все=ве́сь науга
за год=по́дында́кенъ	^
за дверью=ма́дандак
за день=те́лендакен
за домом=ма́тындак
за месяц=эре́нда́кен I плата
за нас=ме́чатъ, меча́дантъ, меча́доген
за неделю=неде́ль да́кен )
за пищей=абсо́тинно
за столом=сто́лындак
за хлебом=ня́енно
за это=на́мы́но́
забежать=тикуро́лгу
забеременеть о животных=инма́дыргу
заблудиться=ма́гыльчимбыгу, ё́ргугу
забор=забо́р
заботиться=забо́тимгу
заботливость=забо́та
забывчивый=ку́д ча́ст<а>нг а́вольҗиннан
забыть=а́вольҗигу
завалить чем=ка́йгу
завалиться о скоте=пы́нгылымбыгу
завернуть=поро́льҗигу
завернуться=поро́льҗимбыгу
завертка=завё́рка
завидовать=зави́димгу
завтра=карзе́н
завязать=са́ргу
завязить=манге́дигу
завязнуть=токва́тку
завянуть=илле́ пы́нголгу
загадать загадку=ню́ргу, катку́
заглядеться=тиманҗе́чикугу, инне́н маннембыгу
загнать=ка́ннингу
загнуть=каро́льҗигу
заговорить=че́нчилею́боргу
загореть лицо=мю́зыгу
загореться=поре́ндчигу
загородить=та́ттыгу, ора́нҗигу
загородить заставить=кондья́ргындымачко́льҗигу
загородиться=ора́нҗичигу
заготовить=запасчи́нгу
загребать землею=гадо́лгу, та́тку, пакылгу
задавить=че́лгынгу, сы́кдыгу
задавить чем=ча́нгыро́льҗигу
задвинуть=чатольҗигу
задний=могне́й
задница=тасе́н
задняя нога=то́п
задуматься=тэйти́келеда́дыргу
задуть=путолгу
задушить=задуши́мгу
заехать=ке́дельҗигу
зажать рот=ора́лгу
зажечь=по́рчигу
зажмуриться=се́ймга́йгу
зажужжать=кы́ныблею́боргу
зайти=се́ргу
заклинать духа=кыча́тчигу
заключить куда=ке́ттыгу
заклясть себя=пи́ремт кыча́тчигу
заколоть ножом=па́зебе́релгу
закон=зако́н
законодатель=зако́нам ми́куд
закоулок=закау́лок
закром=са́ккар
закружить=пю́ронгко́еетыгу
закружиться=пю́ронко́имбыгу
закружиться голова=о́лдогойва́птыгу
закуржевет=ка́даумбыгу
залететь=тимбле́вангу
залив=со́йга
залить водою=ю́с чага́мжлигу
заложить=пе́нгу
заложить между чего=а́рынг са́пе́нгу
заляпать=рока́льҗигу
замаранный=ко́золомбыди
замарать=ко́золгу
замахнуться=утомлаго́льҗигу
заменить одно другим=а́рым о́мдальҗигу
замениться=о́мдальҗигу
замесить=то́ктыгу
заметить=заме́тимгу
замириться=мириса́тчигу
замок=замо́к
замок у ружья=за́кку
замолчать=че́нчилеутыргу
замочить=ёде́птегу
занавесить=ы́дыгу́
занавеска=за́навес
занимать место=ме́ста занима́имгу
заноза=а́думбат
занозить=а́думбыгу
занять=занима́ингу
занять денег=колча́нд и́гу
запад=челчо́ндчь [зачеркнуто], те́лд о́мдырманд
западный=та́нгынди
западня=подпо́льма́да
запасный=запа́снай
запасти=запасчи́нгу
запах=а́ет
запах гнилой=а́етиен
запах испражнений=тю́тиен
запах сладкий=ню́инди а́ет
запереть=кё́ттегу, кё́ттембыгу
запертый=кё́ттембыди
запечатать=печа́таимгу
заплатать пришить заплатку=каби́ ка́бигу заплатить́ ме́рчигу
заплатка=каби́
заплести косу=о́лымпа́тку
заплести ленту=ле́нтам са́ргу
запнуться=пы́кыльчигу, т<а>бо́лгу
запорошить снегом=кыба́нчо́мбыгу
запретить=о́дыргу, а́с кура́льҗигу
запрещать=а́с кура́льҗигу
запрягать запрячь=таета́льҗигу
запутать=пю́втугу
запутаться=пю́угу
запыжить=пы́жкамса́гелгу
запыхаться=кво́й<дам> мидыгу
зарезать=ма́тжегу
зарница хлебозор=Но́м по́рымба
заронить искру=илле́ э́стымбыгу, тю́йбо́рымбыгу
зарумяниться=сорзугу́мбыгу
заря=кыба́льчика че́нгу сю́льҗеле ю́бырымба
зарядить ружье=а́бстугу
заселить=сели́нгу
заслонить=лудо́лҗигу
засмотреться=и́нненма́ннембыгу
засохнуть=ча́гынбыгу
заставить=заста́вимгу
заставить загородить=кондья́ргындымачько́льҗигу
застать где=ква́тчингу заступиться ́та́лымбыгу
заступник=куд та́лымба
засунуть=пе́релгу
засыпать=ка́мҗелгу
затаивать=та́умныгу
затворить=лудо́льҗигу
затем=та́узе
затем что=на́́но́
затемнить=лыба́н ме́гу
затихнуть=зю́льдзилеча́жигу
заткнуть=т<о>го́льҗигу
зато=та́у́но́
затылок=сумба́
захлестнуть=ке́ттыгу
заходить солнце=та́гедимбыгу
зацепиться=ко́дальҗигу
зачать во чреве=инма́дырле ю́быргу
зачаться о младенце=инма́дырле ю́бырчигу
зачем=ка́йно́
зачесться=о́мдальҗигу
зашить=сю́тку
защищать=та́нгымбыгу
заяц=нё́
званный=квы́арбыдимы
звать в гости=квы́аргу
звезда=кызга́нсе́й
звезда вечерняя=ю́ди кво́дди кызынга́нсей
звезда утренняя=каре кво́дди кызынга́нсей
звенеть=лае́етыгу
звенит колокол=коура́къ́ ыэ́чьжин
звери=су́рула
зверок=су́румби
зверь=су́рум
звонить в колокол=мо́тку
звонкий=ля́ымбыдимы
звонко=ля́ымбыди е́нг
звук=му́зымбыдимы
звучать=музымбыгу
звучный=му́зымбыди
здесь=ты́ндъ, тíунт
здороваться=чуло́мчигу
здравствуй=чуло́м
зевнуть=а́бымбыгу
зеленая трава=па́дын ню́тчь
зеленеть=па́дын метугу
зеленый=па́дын
зелень=ню́тчь
земля=чво́чь
земляк вместо земля=чу земной ́чво́чеги
зеркало=ма́нҗерсан
зерно=а́рманзе́й
зерно овса=со́лу
зерно ржи=а́рзе
зерно ячменя=а́рма
зигзагами криво=пана́н ча́жемба, каро́кам ча́жемба
зима=кэ́т
зимний=кэ́й
зимовать=кэ́ргу
злоба=аво́нэ́ппыдимы
злобствовать=авой тэ́йербыгу
злодей=во́р<е> гом
злой=аво́й
злопомнение=ста́рай аво́ймы тэ́йербындать
злословить=ты ту
злоумышление=аво́й тэ́й
змеиный=сю́нзиди
змея=сю́
змея водяная=ё́десю
знание=ко́стымбыдимы
знать=ты́нногу
золотить=золоти́мгу
золото=золота
золото=альто́н [зачеркнуто]
золотой=золото́й, альто́ни [зачеркнуто]
зуб=те́ в
зудит=кы́зынбыгу
зыбка=чо́бс
зябнуть=канде́зигу
зять=эмне́у
и=а́й
ива=ту́льҗре
иголка=мыга́
игольник=мыга́нчо́лк
игольные уши=пют
играть=ва́ркыгу, са́нҗиргу
играть на балалайке=ке́ттелбыгу
играть на гармонике=н<и́>гырчигу
играть на дудке=са́н җиргу
играть на скрипке=на́ндчигу
идти=ча́җигу
идти впереди=уко́н ча́җигу
идти по следам=вато́унтча́жигу [ исправлено из вато́унтча́җигу]
из=до́ (после существительного])
из всего видно=се́ланъ́ а́дон
из которой=ка́ймыгын [зачеркнуто]
из под=ыло́нды, ыло́гынды (после существительного])
из под дерева=поныло́нды
из под дома=ма́тыныло́нды
из под подполья=подпо́лылогынды
из под стола=столыло́гынды
из тех людей=на́гуландо
из усердия=седе́гунд
из-за=до́гуван (после сущ[ествительного])
из-за двери=ма́дандо́гуван
из-за дома=ма́ткындо́гуван [изъ́за] стола́ сто́ландо́гуван
избавить=парани́лгу, изба́вимгу
избавиться=парани́лчигу, изба́витчигу
избегать остерегаться=токе́скугу
избегать убегать=токуро́лгу
избранный=выбира́имбыди
избрать=выбира́имгу
избыточествовать=ли́шнан э́зыгу
извертеть=па́кылгу
известить=ве́стим ю́дыгу [исправлено из вепстим миОдыгу]
известный=изве́снай, знако́май
изгрызенный=туто́лбыдимы
изгрызть=туто́лбыгу
издавать звук=ку торгу
издалека звучать=му́зымбыгу
издали=кундо́кындо
излишек=ли́шнан э́зыгу
изломанный=пана́лбыди
изломаться=пана́лгу
измениться=а́с ны́льди ме́гугу
измятый=пё́ктылбыди
измять=пё́ктылгу
изнанка=а́с ва́нд
изнемогать=а́лконме́гугу
изношенный ветхий=лакча́нби
изорванный ветхий=лакча́нби
изорваться=нычькыльҗигу
израненный=панпе́релбыди
изрубить=пача́лгу
изукрасить=краси́ван ме́гу
изъедать=а́мгу
изъеденный=а́мбыдимы
икона=Но́м
икра ноги=про́чь
икра рыбья=ты́рым
или=а́ли
иметь попечение=забо́тимгу
имя=не́м
иначе=тэдатар
иначе сказать=тедата́р катку́
иней=ка́дамба пы́нгылымынды
иногда=ка́йгнемеле́
искать=пе́гу, пе́гылгу, пе́рынҗигу
искра=тю́й
искриться снег=чу́льҗеле ча́жигу, чу́дыледадыргу
искусник=ма́стер
искусный=ки́тырнан
искушать=искуси́мгу
искушение=искуше́нья
исповедать=пове́даимгу
исповедаться=нё́рбалгу
исподки=испо́дка
исполнитель=ку́д ме́мбанъ, ме́куд
исполнить=ме́гу
испортить=испо́ртимгу
исправить=пра́вимгу
исправиться=сво́н э́зыгу
испугаться=кы́чьватгу
испытай=ма́ннембет ква́ллебе
испытать=про́баи мгу, пыта́имгу
исследовать=ма́стерын ко́стыгу
иссушить=ча́гыргу, чаго́етыгу
истратить=тра́тимгу, тра́тиледа́дыргу
истребить=мизе́лгу
иступить=кыа́н э́стыгу
иступленный=кыа́нэ́стымбыди
исчезнуть=ё́ргу
к верху=котте́
к воде=ё́тындоты
к дороге=ва́тындоты
к реке=ква́йендоты
к тому=на́мынт
к чему=до́ты
кадило=кади́лан
кадить=кади́ланкю́ргу
кадочка=ка́чка
каждый=ка́жнай
кажется=ка́жеца
как=кунда́р
как будто=калака́й
как-нибудь=кунда́р ем
какой=кунда́р еди́
какой то=ко́дъ́та́
какой то особый=ко́д та а́рым
какой-нибудь=ка́ем и
калина дерево=кали́на по́
калить=ча́дыгу
калым за невесту=калы́м
камень=пю́ллага
камень драгоценный=драгосе́ннай ка́мен
канат=кудго́
канат толстый=ча́рым кудго́
кандалы ножные=топоти кандалы́
кандалы ручные=уто́ги кандалы́
капать=ча́пымбыгу
капать о воде=са́гамбыгу
капкан=се́п кой га́пка
капля=ка́пелька
капсуль ружья=ка́псон
карась=тудо́
карий=ка́ряй
катать колесом=пю́нглеетымбыгу, пю́ронг ко́ирыгу
катать круглое=пю́нгульҗигу
кататься в салазках=ю́гулбыгу
кататься на лошади=гуля́йчигу
кататься с горы=не́сыргу
катиться лежа=пю́ронко́ирыгу
катиться шаром=пюн́гольҗильжигу
качать=ко́гургу
качать головою=о́лом ла́гыргу
качать ребенка=ку́гургу
качаться на качелях=ку́гургужи<гу>
качели=казла́
кашлять=котку́
каяться=ка́имбыгу
квашня=ня́ика́чка
кедр=те́тынг
кедровая шишка=сва́нгын о́л
кивать головой=о́лонд мы́нҗиргу
кидаться собака=па́ктыргу
кипеть=пе́рчигу
кирпичь=кырбы́чь
кислое молоко=ча́псен молоко
кислый=ки́слай е́нг
кишки=кё́дла
кладбища=каги́т
кланяться=о́мдалгу
кланяться до земли=о́мдалгугу
класть=пе́нгу
клевать=па́читыгу
клевета=та́гола аво́н че́нчимбыди
клеветать=та́гола ав<о́й> че́нчигу, ча́рыгу
клеветник=та́гола ча́рымбыди ко́м
клеи рыбий=чи́в
клепцы ловушка=ча́кос
клюка=клюка́
ключь замочный=кле́зенгво́з
ключь ручей=со́й
клясться=не́вончигу
клятва=не́вончимбыдимы́
книжное слово=книжнай ыэ́чь
книжный=кни́жнай
кнут=ка́рсын
князь=князь
коблук у ноги=сын га́
кобыла=сю́м
коварство=а́лымбыдимы
ковать=кова́ингу
ковш=кво́зкала́
ковырять=па́гатыгу
когда=куса́кын
когда-нибудь=куса́кын е́м
коготь=ка́т
кожа=ко́п
кожа выделанная=чу́гунко́п
кожа животного=ко́п
кожаный=ко́жанай
кол=ко́л
колдун=ккэ́тцыенг
колебаться=ни́льдинг тэ́йербыгуай нанде́р тэ́йербыгу
колено=пулзе́й
колесо=колесо́
колода=по́лдоб
колодник=чурме́гам а́мнымбыди ко́м
колокол=коура́к
колонок=колоно́к
колотить=ке́ттелбыгу
колоть=чо́калгу
колупать=то́гадолгу
колчан для стрел=пура
колыхаться=ти́клымбыгу
кольцо=пю́р
кольчуга=кво́зи ка́порг
комар=не́нка
комната=ма́дансюнчь
конец=та́бытъ, ко́нчь
конец беременности=инма́дырле ко́нчь
кончить=ма́льчугу
копать=ко́патыгу
копить деньги=ко́мде та́келеда́дыргу
копыто=салла́к
кора=по́нка́с
корень=по́нко́нҗь корень
корка=ка́ст
корм=а́бсот
корма лодки=а́ндынтасе́н
кормить=а́бстгу
кормить грудью=не́псензе не́ургу [исправлено из не́псензе у́румгу]
кормить ребенка рожком=у́румгу, не́ургу [зачеркнуто]
кормовое весло=кормо́вой ла́п
кормовщик=а́ндентасе́нди ко́м
кормчий=кормово́й ко́мъ, а́ндентасе́нди ко́м
корова=сы́р
короткий=ка́вкан
кортом=ко́рт
кортом заплатить=ко́рт ме́рчигу
корчить=мутальчигу
коршун=э́ттча
корысть прибыль=коры́с
корыто бельевое=коры́то
корыто для рыбы=чангнэ́
корыто маленькое=чангнэ́ка
корь съела=чо́к <а́>мбат
коса на берегу=каса́, чо́р
коса песчаная в реке=каро́чь
косить=па́четыгу
косматый=ле́йбайо́ли
косой=косо́й
косоплетка=незо́
кость=лы́
костяной=лы́й
косынка=косы́нка
косяк двери=коло́да мада́н
косяк окна=коло́да око́скон
котел=кво́зильди
который=кудъ, ко́д
который слушает=ю́нгольчимбыди
кочка болотная=ка́льҗно́л
кошка=ко́шка
кошма=нё́й
краденый=твы́олбыдимы
край=кра́й, до́б
крайний=кра́йгеи, <те́га тига́ тебе́комъ> [зачеркнуто]
крапать дождик=васке́птыгу
крапива=са́тчь
красавец=те́га тига́ тебе́ком
красавица=не́йгомъ, во́тъу́ж сво́енг
кроткий=чё́нҗика го́м
крошить=ма́челгу
крошка хлеба=сыка́
круглый=пю́рое́нг
кругом виноват=ку́ргом винова́тан е́нг
кругом ходить=ко́ирыгу
кружить=ко́ирыгу
крупный=кру́пнай е́нг
крутой=ма́чен е́нг
крыло=ту́тъ, каро́чь
крыльцо=кры́ниса
крюк деревянный=кода́
крючком=кода́кан е́нг
крючок железный=кэ́тер
крючок у зыбки=пы́нгырса́н
крякать кряхтеть=ча́гыгу
кто-то=ко́д та
кувыркаться=па́рынмачко́льҗигу
куда=куте́нъ, ку́
куда-нибудь=ку́емъ, куэмеле́, кудте́тем
кудрявый=кудря́вай
кукла=нэ́ка
кукушка=са́гвя
кулак=кло́ка
кулик=со́с
кулик долгохвостый=санҗо́ка
кум кума=кума́, куманё́к
купаться=у́ргу
купить=та́угу
куржевень=ка́даумба
курить=ня́кылгу курить чöмъ,
куриться=кашко́йбыгу
курица=ку́риса
курносый=курно́скай
курок ружья=тю́льсенса́кку
куропатка=у
курья=ку́ссере
кусаться кусать=о́ттагу
кусок=кусо́ка
кустарник=су́нгъ, со́ггы
кушанья=а́бсот
лавка скамья=ла́кун
ладонь=ча́ндчьпе́ка
лазить=сы́голгу
ласка зверок=ла́ска
ласкать=твэ́дылбыгу
ласковый человек=сво́гом
ласточка=квеге́лька
лаять=му́дыгу
лгать=седе́етыгу, сизя́ктымбыгу
лебедь=чи́нг
левая рука=кво́дте уть
левая сторона материи=а́с ва́нд
легкий=са́пка е́нг
лед=улго́
лед ломает=улго́ питколледа́дрыт
лед набросало=улго́ коннекы́лбат
ледяной=улго́й
лежать=э́пегу
лежать без памяти=э́пегу а́с ты́нногу
лекарь=ле́карь
лелеять=не́жарольҗимбыгу
ленивый=а́с кы́гынди го́м
лень=ле́нь
лепешка=лепё́шка
лепить=ня́гант па́рчигу
лес=ня́ргса́н
лес тайга=ма́ть
лестница=сы́рсапо́
летать=ти́мбыгу
летний=ё́ти
лето=та́ыд
летовать=та́ыргу
летучая мышь=ко́тынг
лечиться=легчи́тчигу
лжепророк=а́лынкунди проро́к
лжеучитель=а́лынкунди учи ́тель
лизать=нютылгу
лизнуть=ню́голгу
линь рыба=ка́вья
линючий=чарзо́димы
линять о животном=пучва́леча́жигу
линять о материи=ча́ргу
лисица=лога́
лист=ня́ргынча́б
лист отпал=топы́кыльчимба
лиственница=ти́у
лисья нора=о́рто
лить=га́мҗигу
лить из свинца=га́мҗигу
лихорадка=су́зря
лице=ва́нд
лице материи=ва́нд
лишенный=на́гомъ, кудынна́н ора́лле и́мбат
лишиться=ё́ргу, ё́рчигу, реши́тчигу
лишний=л́ишн<а>й
лишь только=э́рынг
лоб=ча́ндчьга́н
лобзание=ни́дымбыдимы
лобзать=ни́дгу, <ч>око́льҗигу
ловить=пенҗигу
ловить рыбу удочкою=мисчо́лгу
ловушка=лаву́ска
лог=со́й
лодка=а́нда
ложа ружья=тю́льсемпо́
ложиться=эпенҗигу
ложиться спать=э́пегу ко́ндыгу
ложка=сола́н
ложный=а́с справедливан е́нь, а́лынкунди
ложь=ас правда
локоть=сы́нчел
лопата=лопа́та
лопнуть=пассе́дигу
лоскуток=лоскутка́
лосниться=по́ромбыгу
лось=пе́нк
лота годы=по́д
лошадь=кю́нт
лубок=ду́б
луг=ню́рт
лужа=Но́м со́рымба, ю́т капсе́димба
лук для лисицы=ындэ́
лук для стрелы=ы́нд
лукавый человек=мо́лади го́м
луч=кызга́
лучина=лучи́на
лучистый=кызга́й
лучше=лу́ччилаг
лучший=лу́ччи
лыжи=то́льчь
лынтаи обувь=лынта́й
льдина=сырле́м
льстивые слова=а́лынкунди ыэ́чьла, сизя́ктымбыди ыэ́чьла
льстить=седе́птыгу
любезные дети=любе́знай ийма́тла
любезный=свыо́рынди, любе́знай
любимый=сво́рынди
любить=свы́аргу
любовница=любо́вниса
любопытный=любопы́тный
любящий=сво́ркунди
лягать лягаться=та́птыгу
лягушка=ча́мҗ
ляшки=лё́кылы
мазать=ма́зингу
макать=та́кугу
маленький=кыба́енгъ, кы́бальчига
маленько=кве́н
малина=синдя́кан а́бсот
мало=та́нака е́нг
малорослый=а́с пы́р го́м
мальчик=кыба́ го́м
манить=кво́ргу, мани́нгу
манить рукой=утом ла́гыргу
марать мараться=ко́золгу
масло=ма́сло
масляный=ма́слан ма́зимбат
мастер=ма́стер
матерний=а́утди
матка в потолке=по́рс
матушка=а́ва
мать=э́вел
махать=ла́гыргу
махнуть рукой=утон ла́гыргу
маяться=маиса́тчигу
маячить рукой=утон ла́гыргу
медведь=кво́рокъ, су́рум
медленно=чё́нҗенг
медленный человек=чё́нҗен ме́кунди
медлить=чё́нҗигу
медный=тула́й
медь=ту́ла
между=кечё́льдчь
между расстояние=сы́дыго́дет
между собою=о́ндзенягын
мелкий=ме́лкай е́нг
мель на воде=ча́в
менять=та́ргу
мерзлый=ка́ннымбыди
мерить=ма́нҗигу
мерка ружья=ме́рка
мерлушка=мерлушка
мертвый=ку́мбыди
меру встрясти=лагеетыгу
меру надавить=илле́тигылгу
меру насыпать=тiерлега́мҗигу
меру насыпать с верхом=верхын га́мҗигу
месить=то́ктыгу
мести=чо́балгу
место=место, чво́чь
место сухое=чво́чь ча́гымба
место сырое=чво́чь ё́доумба
месть=аво́ймым ме́рчимбыдимы
месяц=э́рет
метать сено=мя́ктылгу
метель=пурга, бура́н
метла=чо́па
мех=ме́к
мешать чем=ны́нгольҗигу
мешать что=то́ктугу, меса́имгу
мешок=коча́
мешочек для дроби=дро́бикоча́
мигать=се́ймы́рыргу
милосердый=ми́лостиван е́нг седе́узе
милостивый=ми́лостиван
милостыню подать=ма́дыре ко́мде ми́гу, ми́лостыням ми́гу
милостыню просить=Ну́мды ма́дыргу
милостыня=ми́лостыня
милость=ми́лость
милый человек=сво́чьга го́м
мириться=мириса́тчигу
младенец женского полу=не́йгом
младенец мужского полу=тебетом
младенец общее название=са́дыка кыба́ го́м
младший=кыба́енг
много=ко́чиенгъ, тэ́игда
многомилостивый=ко́чи ми́лостивай многообразный,
многоразличный=ко́чи ра́знай
многоценный=путё́м мерсе́й
множество=тэ́йгалк е́нгъ, ко́чи
могила засыпанная=каги́тъ, кага́й ма́кка
могила яма=кы́л
мозг=ке́юв [исправлено из ке́юввъ]
мозг в костях=лы́ди ке́юв
мозг головной=о́лын ке́юв [исправлено из ке́юввъ]
мокрый=ю́думбыди
молвить=ыэ́чьжигу
молиться богу=Но́мт о́мтыгу
молния=Но́м те́лырнан
молодая девица=одчеде́й кыба́ не́й гомъ, де́пка
молодая женщина=одчеде́й не́й го́м
молодой человек=одчеде́й го́м
молоко=молоко́, не́пса
молоко матернее=а́утди не́пса
молотить хлеб=молоти́тчигу
молоть=на́дыргу
молчаливый=кю́гальҗиле свыо́ркунди
молчать=кюга́н енгу, кюга́льҗигу
моргать=мыре́тчинбыгу
морда для рыбы=ка́р
морда человеку в морду=вандо́унт
море=мо́ре
мороз=те́ссунг
морозная ночь=ка́рымбат пе́н
морошка ягода=пал го́
морской=мо́реги
мост=мо́ст
мостить=мо́стычингу
мотылек=ла́мерека
мох=чу́мб
мохнатый=пы́рлай
моховой=ме́ксуй
мочить=ёде́птегу
мочь могу=могу́, мо́жет
мошка=сыба́рго
мстить=ава́йзе могне́ ми́гу
муж=эра́у, тебе́у
муж в летах=те́бынче́нжи го́м
мужеложствовать=тебе́кум́ ма́тку
мужеский=тебе́ку́м
мужик=тебе́гом
мука=мука
мука хлебная=мо́ка
муксун рыба=ко́р
муравей=кыча́
муравейник=кыча́й ма́кка
мускул=че́н
муха=чибе́
мучить=мучимбыгу
мучиться=мучиса́тчигу
мылить=мылазена́тку́льҗигу
мыло=мы́ла
мыслить=тэ́йрбыгу
мысль=тэ́й
мыть руку=уто́н мё́золдчигу
мыть стирать=мю́золдчикучигу
мыться=мё́золдчигу
мычать=па́ркугу
мышеловка=чан го́
мышца=календа́б
мышь=та́ва
мягкий=пуда́кан е́нгъ, нипсыка́н е́нг
мязга древесная=ко́пыт
мякиш хлебный=пу́чит
мясной=ва́ти
мясо тело=ва́ть, кё́дынва́ть
мятеж=бу́нт
мять=пе́ктылгу
на него=табни
на них=таблани
на свои деньги=о́ненд ко́мнензе
на цыпочках=чи́гальчика
набить=саке́ллепе́нгу
набожный человек=Но́мт о́мтымбыди ко́м
набок=кё́н
набросать=кы́лгу
наверное=наве́рна
навернуться о слезе=се́йндгойча́нныгу
навести что=наведи́мгу
навет=та́гола аво́н че́нчимбыди
наветовать=та тола аво́н че́нчигу
навлечь=менде́лгу
навоз=саба́н
нагишом=нельде́нкопи
нагнуться=муга́льдчигу
нагой=а́с че́мбытбыди
наголовник=олыза́ри
надежда=наде́жда
надеть=се́ргу
надеяться=наде́ямбыгу
надзиратель=ма́ннемкунди ко́м
надзирать=ма́ннембыгу
надмеваться=ва́ргыльҗигу
надобно=на́добнан е́нг
надоедать надоесть=наску́чимгу
надолго=ку́ндун
надолго достанет=ку́ндынгъ́ меде́нчит
надсматривать=ма́ннембыгу
надсмотрщик=ма́ннемкунди ко́м
надуваться натужиться=крепи́мбыгу
наедине=о́кырзе, сы́дъяг
наживать=нажива́йчигу
назад=могне́
назад отдать=могне́ ми ту
назвать=не́мбыгу [исправлено из не́мнембыгу]
назначить=назна́чимгу
называться=не́мнембыгу
найти=коту
найтись=ко́гымбыгу
наказание=наказа́нья
наказать=накази́мгу
накануне=те́лдзел
накидать большую кучу=ва́ргын пы́ргын тел ь җигу
накипель=сы́рбан
наклонить=о́мдальҗигу
наклониться=муга́льдчигу
наконец=нынблэ́
налим=ню́
налить=га́мҗигу, тiерлега́мҗигу
наложить=пе́нгу
намостить=мо́стычингу
нанизывать=со́нгургу, че́тчигу
нанять=ле́йдыгу
наняться=лейде́нчигу
нападение греха=искуше́нья
напасть беда=беда́
напасть на шею=нуко́унт ка́валгу
напасть нападать=напади́нгу, па́ктыргу
написать=на́гыргу
напиться=ю́дырчигу
наплавок=ка́з
напоить=юто́льҗигу
наполнить=тiерлембыгу
наполниться=тiерлебчимбыгу
напомнить=табни́ тэ́йербыгу
направить=на́ вато́унт ква́ндыгу, напра́вимгу
направить дорогу=вато́нт пра́вимгу
направиться идти=вато́нт пра́вильҗигу
напрасно=та́гола
народился месяц=эре́т са́ндери те́лымбан
нарочно=наро́шнан е́нг
нарта=ка́нҗь
нарядиться=наряди́мгу
насадить=о́мдальҗигу
насилование=пана́лбыдимы
насиловать=си́ла<мъ> ора́лгу, пана́лгу
насилу=насу́ль
наслаждаться=ню́инди э́лгу, сла́дкан а́ворле
наследовать=насле́димгу
наследство=насле́детва
насмехаться=пе́скугу
насмешки=писку́м
наст по снегу=ка́нтъ, к<о́>м ва́тчимба
настлать=чаты нгу
настоящий=тида́мди, тамбо́й
настращать=ла́рчимбыгу
настроить инструмент=ня́кыльҗи пра́вимгу
настроить подучить=о́дальҗигу, оголчо́лҗигу
наступить на что=те́гальдчигу
насупротив=кё́йгонд
насыпать=га́мҗигу
насытиться=ка́пучигу
науськать=о́дальҗигу
научить=оголчо́лҗигу
нахмуриться=ва́ндым пирса́льҗигу
находить о туче=ва́зилечажигу
находиться=эту
находка=ко́мбыдимы
начало=у́гут
начальствовать=нача́льникангле эгу, ме́гугу
начаток плодов=пе́рвай чо́бырла
начать=ю́бы ргу
начаться=ю́бырчигу [исправлено из ю́бырличигу]
начерпать=камҗе́лгу
не=а́съ, ы́къ, этыст
не во сне а наяву=ко́нҗиргу
не давать=а́с ми́кугу
не заботиться=а́с забо́тимгу
не забудь=ы́к а́вольҗет
не забыть=а́с а́вольҗигу
не запрещать=а́с а́с кура́льҗигу
не зевай=сытоне́нней ы́к ма́нҗельбак
не любить=а́с свы́аргу
не смей=ы́к миттембе́т
не так=а́с нильдинг
не татары ли=а́с ты́ла ли
не возбранять=а́с а́с кура́льҗигу
не ладится=ла́дица а́с э́зыкван
не обидливый=на́гом ника́к сорди́тан а́с эсте́нҗин
не обинуясь=та́умнымбыгунҗалт
не обманчивый=а́с а́лымбыди, а́с сизя́ктымбыди
не однажды=а́с о́кырынг
не перестающий=а́с у́тырымбыди
не попасть в цель=ы́к чарку
не послушаться=а́с ю́нгольҗигу [исправлено из а́с ю́нгольҗигугу]
не походить=а́с ня́мди пю́тти э́зыгу
не радеть=а́с забо́тимгу
не скверный=а́с скве́рнан е́нг
не скрывая=та́умнымбыгунҗалт
не смертельный=а́с куссо́ди
не смочь=ла́рымбыле ме́гу, а́с насме́литчигу
не согласиться=а́с кы́гыгу
не спать бодрствовать=пё́тыгу
не стараться=а́с стара́йчигу
не торопиться=чё́нҗигу, а́с ты́дыгу а́с кы́гугу нунси́нчегой,
не успокоен=ме́мба о́мделе а́с ма́льчимба
не утаиваться=а́с та́умтыгу
не хватило чего=а́с меде́нбан
не хотеть=а́с кы́гугу
небесный=но́мгеи
небо=ну́н си́нчь
небо во рту=кы́нгыр
небрежность=а́с стара́нья
небречь=а́с стара́йчигу
невежество=а́с ко́стымбыдимы
неверие=а́с ве́ра
невеста=неве́ста
невинно=та́гола
невод=ляво́да
невозбранно=ку́дын нэ́й а́с меса́имба
неволя=а́с во́лен
невыразимый=сво́мы тако́й сказа́ть нельзя́
негодование=те́мба
недавно=а́с ку́ндыкван
недоносок младенец=ку́мбыди те́лымба
недостает=а́с ми́тукван
недоступный=поступи́нэ́зыгу нельзя́, кэ́гент ква́нгу нельзя́
недосуг=недосу́к
недоумевать=а́с ты́нногу, ка́й тэ́йербыгу
нежели прежде=уко́н на́умы кунда́р
нездешний=а́с ты́нди
незлобивый=ку́д аво́ймы а́с меледадырыт
незнание=а́с ко́стымбыдимы
неизвестный=а́с изве́снай, а́с знако́май
некогда=недосу́к эва́н
некрасивый=а́с сво́
некуда=куте́тгат
некуда деваться=куте́т каде́н җигу
нелинючий=а́с чарзо́димы
нельзя=а́с мо́жна, нельзя́
нельзя=аво́й э́ванъ, э́зынъ, э́нчит
нельма рыба=ва́нчь
немало=а́с та́нака, а́с ко́чин (иногда говорятъ)
немного=а́с ко́чи
немного погодя=э́ттанг э́лебе
немой=се́гда, се́галк
немощный=мессалай, а́лкой
ненавидеть=ка́ндыбынг а́с свы́аргу
ненависть=ка́ндыбынг а́с свы́арындимы
ненадолго=а́с ку́нт
ненастье=лыско́т
ненастье=Но́м ке́тынба
ненастье продолжительное=во́дерен ке́тынба
неоконченный=а́с ма́льчимбыди
неплодие=а́с ко́кунбыдимы
неплодная женщина=инма́дым а́с ко́куд
непорочный=поро́кангалк
неправда=а́с пра́вда
неправду говорить=седе́птыгу
неправедная мзда=а́с справедли́вай пла́т
нерадение=ле́нь, а́с забо́та
неразумный=тэ́йгыди
нераскаянный=а́с ка́итса́й го́м
несказанный=катку а́с мо́жнан е́нг
несколько=куса́йес
несправедливая плата=а́с справедли́вай пла́т
несправедливо=а́с справедли́ванг
нестроение инструмента=а́с ня́кыльҗи
нет=ча́нгван [исправлено из ча́нго]
нет разницы=ра́знисам ча́нгван
нетерпеливый=а́с терпи́мбыдимы, терпи́мгыди
неувядаемый=а́с пы́нгылко́унь
неужели=аразе́
неукротимый=табни́сми́рнан ме́гу аво́й е́нг
неусыпно=путё́м
неутвержденный=а́с утверди ́мбыди
нечаянно=неча́янна
нечего=не́чего
нечестный=ненаде́жнан го́м
нечистота=а́с чи́стан е́нг
ни за что=да́ром
нигде не=ко́с ка́йгын нэ́й а́с
ниже=ла́мдылаг
нижний=чво́ченба́рым
низать бисер=со́нгургу, че́тчигу
низенький=ла-мдыкала-н(ен)гь
низкий=ла́мдыка е́нгь
низлагать низложить=нянпа́рыт илле́й пе́нгу
никакой человек=ко́с ка́й го́м нэ́ а́с
никогда=куса́кын нэ́ас
никого не=ко́с ку́дым нэ́й а́с
никому не=ко́с ку́дыни нэ́й а́с
никто=ко́с ка́й нэ́ас
нитка=сеть
ничего нестоящий=ка́йда а́с сто́имбыди
ничего ничто=ка́й не́й
ничтожный=ка́йда а́с сто́имбыди
нищий=ни́щiй эра́
новорожденный=а́с кундо́кын те́лымба
новый=се́нт е́нг
нога=то́п
нога задняя у животного=то́п
нога передняя у животного=у́т
ноготь=ка́т
ножик=па́
ножницы=сы́донепа́ [ исправлено из сы́дыпа́]
ножны=па́ндзан
ноздря=пучино́лсе́нчь
нора лисья=орто́
нос=пучино́лъ, пучь
нос у лодки=а́ндыно́л
носить=та́дыргу
ночевать=се́нгыгу
ночной=пи́т
ночь=пи́н
ночь темная=твы́ольҗибеть
нравиться=нра́винэ́стыгу
ну-ка=а́ра
нужно=на́добнан е́нг
ныне нынче=тида́м
нынешний=та́мбой, тида́мди
нырковатый=кока́мака, нырка́зей
нырнуть=па́дыргу, па́дкылгу
нюхать обонять=абсте́етымбыгу
нюхать табак=ня́кылгу
нянька=ня́нька
о котором=ку́дынчат
о малом=та́наканчат
о многом=ко́чинчат
о себе=о́ненчат
о том=на́унчат
о чем=ка́енчат об немъ́ т<а́>бынмынди
об себе=пи́ренчат
об этом=та́унчат
оба=сыннэ́
обвязать обвязаться=са́ргу
обгонять=ка́леква́ндыгу
обделить=ма́ла ми́гу
обессилеть=о́ромкы́лынгу
обет обещание=обесча́имбыдимы, обесча́нья
обещать=сули́мбыгу, обесча́йчигу [исправлено из обещай́мбыгу]
обидеться=оби́дильчигу
обижать=обижа́имгу
обильно=путё́м ко́чи е́нг
обладать=владе́имгу
облако=ти́т
обласкать=свыо́ргу
обласок=кыба́ а́ндок
облегчить=са́пкаммегу
облечься=се́ргу
облизнуться=ню́гуледа́дыргу
облистать=чо́голонбыгу
облистать с неба=Ну́н Ма́дан ню́гудин
облить=га́мҗигу
обличать=уличи́мгу
обложить кругом=пю́ронг пе́нгу, пю́ронг квая́льҗигу, квая́льҗиле пе́нгу
облокотиться=чо́ргыльҗигу
обмакнуть=та́кугу
обман=а́лрад
обмануть=а́лынгу, сизя́ктыгу
обмануться=а́лынчигу, сизя́ктымчигу
обманчивые слова=сизя́ктымбыди ыэ́чьла
обманщик=сизя́ктымбыди ко́м, а́лынҗан
обмотать и завязать=са́ргу
обмывать покойника=мё́золчигу
обнимать за шею=нуко́унт ка́валгу
обнимать обниматься=ка́валгу
обновка=са́ндымы
обнять=ка́валгу
обо всем=ча́лын
обогащать=ко́умбыди ме́гу
ободрать зверя=ко́пынты́кыргу
ободриться=перва́ ла́рымба т<и́>дам че́тчигу кыгы́нъ, че́тчигу кыгы́нъ, ине́лан э́зыгу, тру́к ва́рсыватку
обойди место=квая́льҗигу
оборвать=лакче́лгылгу
оборонить=парани́лгу
оборотиться=могне́ питалгу
оборотиться назад=могне́ питалгу [строка зачеркнута]
обоюдоострый=а́ублекант нежо́кан е́нгъ, сыто́н алиба́
образ=о́бразъ, Но́м
образ подобие=ти́ка пая́
обрасти=о́рымкылгу
обратиться к кому=питалгу
обращаться ласково=ла́сково точа́жембыгу
обрезание=тема́чимбыдимы
обрезать=ма́чгу, тема́чьгу, а́тыргу
обрить=ню́кланпю́жигу
оброк=ко́ртъ, пла́т
обронить=э́стыгу, э́рнигу
обруч=ча́нгу
обручение=обруча́имбыдимы
обручить=обручи́мгу
обсушиться=чаго́етыгу
обтесать=ка́балгу
обточить=се́лъелгу́
обувать обуваться=се́ргу
обуздать=анга́имтока́льҗигу
обучить=оголчо́лҗигу
обшевни сани=ро́звадни
объяснить=тэ́йербыгу, ка́ткылгу, па́ктылгу
обыкновенно=накаве́нна
овдоветь=са́рымбыгу, ка́лымбыгу
овод=пю́
овраг=ё́ткыдисо́й
овца=коне́рка
овчина=коне́рканко́п
огласить=та́бынчат катку́
оглашенный=та́бынмынди ке́тбыди э́ ́зын
оглобля=алла́йпо
оглохнуть=ко́гологу
оглушить=ке́ттыгу
оглядеться=ма́ннембыгу
оглянуться=пи́кильчигу огненный ́тю́йзиди
огниво=сакко́
огонь=тю́й
огребаться=ка́ттыгу
одеваться=че́мбытгу
одежда=егыда́л [исправлено из егылда́ктъ]
одетый человек=че́мбытбыди
одеться=че́мбытгу
одеться одеялом=чо́ндыгу
одеяло=чё́нҗь, оде́яла
один=о́кыр
один другого=ни́емди
один за другим=ня́ндыго́йгон
один остался=пе́галк
одинаковый=о́кырназа́й
одинокий=пе́лгыди
одичать=матыльчигу
однажды=о́кырынг
одобрить=а́ндугу
одоление=одоле́нья
одолеть победить=одоли́мгу
одолжить=колча́ндми́гу [исправлено из колча́ндмегу]
одурачить=дура́кын мету, пе́скугу
ожесточать=жесто́кан мету
ожесточиться=сво́ го́м э́с ай аво́й ме́гумбан
ожить оживлять=иле́димбыгу, иле́етымбыгу
озариться=те́ллыле ю́быргу
озеро=чагэ́
озеро запорное=чво́р
озеро карасевое=то́
озлиться=ва́ргынкво́дынбыгу
озлобить=серди́тан а́стугу, кво́дыльчо́льҗигу
ознобить=па́ктыргу
ознобленное место=па́ктырбыдимы
озябнуть=ка́ндечигу
окно=око́ско
около=пю́ронг
окончить=ма́льчугу
окружать=пю́ронгу
окружить=квая́льҗигу
окунь=ка́за
олень=а́дъача́
оловянный=ня́ургвоз
омрачиться=лыба́н ме́гугу
опаленный=по́рчимбыди, ча́дымбыди
опалить=по́рчигу, ча́дыгу
опасаться=ла́рымбыгу
оплакивать=ку́ндынг чу́рогу
оплевать=све́зыгу
опнуться=а́с ку́ндынг эту
опомниться=падче́дигу
оправдание=оправда́йбыдимы
оправдаться=оправда́йчигу, пра́в<утту> ква́нгу
опрокинуть=кавте́ ча́жигу
опустить книзу=та ту
опустить курок тихо=са́ккумю́дыгу
опустить парус=мергега́м а́стугу
опустить пропустить=ю́дыгу
опустошить=пусто́й мету, сю́дзипюн мету
опьянеть=се́ргу
опять=а́йстъ, а́й
орел=лы́мп
орех=сво́нг
оса=лотэ
освежить=арма́бчигу
освободить от других отнять=теи́гу́та́ннынгу
освободиться=манчо́лгу, слабо́днан э́зыгу, метугу, парани́лчугу, о́ндызе токва́нгу
осеклось ружье=нё́гтымбан
осеновать=кы́энгу
осень=ка́ндыкат
осетр=квотер
осина=пи́
осиротеть=че́и э́зыгу, те́гаикале́ндчигу
осквернить=скве́рнан ме́гу
оскверниться=скве́рнан метугу
оскорбиться=оби́дильчигу
оскорблять=кво́дыльчигу
ослабеть=а́лкомме́гугу, сла́бкан метугу
ослабить=сла́бкан мету, а́лком мету ослöпить́ се́йгыльчигу
ослепнуть=се́йгат э́зыгу
осмелиться=ве́ркал э́зыгу, насмöлитчигу
осмолить=са́тку
осмотреть=ма́ннембыгу
основать=о́мдыльҗигу
основать строение=са́ндын по́<п> пе́нгу, са́ндын ма́тым мету, са́ндын пе́нгу, ю́ бы ргу
особо стоять лежать=кра́йгын
особый=ко́дъта а́рым
оспа=о́спа
осрамить=стра́мна ты ту
осрамиться=страми́тчигу
оставаться=кале́ндчигу
оставить=ка́лтыгу
остановить=у́дыргу
остановиться=у́дыръэ́льчигу
остановка в деле=ара́нъ, ав<о́>н о́мдальҗимбан
остаток=ка́лымбыдимы
остаться=ка́лгу остерегаться ́токе́скугу
острие=а́нд
остричь=пю́жигу
остров=о́строг
острожник=чурме́гам а́мнымбыди го́м
острый=нумера́н е́нг
острый=нумера́н е́нгь, нежо́кан е́нг
остудить=казе́етыгу
остыть=канде́зимгу
остяк=сю́ссого́м
остяцкий=сю́ссогой
осуетиться=тэ́йербыгу што́б греши ́тчигу
осуждать=осужда́имгу
осуждение=су́дымбыдимы
ось=о́сь
от=то́, до́
от=до ́ ... а́ндо ́ ... чан
от бога=Нунна́ндо
отбежать=текуро́лгу
отбросить отброситься=точа́җигугу [исправлено язто́чаҗигугу]
отвалить=илле́ пе́нгу
отведать=са́кугу, про́баи мгу
отвергнуть=точа́җигу
отвергнуться=[точа́җи]чи ту
отвергнуться=а́с ка́птыгу
отвернуться=пи́галгу
отвертка ружья=отвё́рка
ответить=келеда́дыргу
отвечать=келледа́дыргу отворить ́ню́гу
отвориться=о́нденю́гу, ню́гучигу отворотить ́а́рынчигу
отвратить=а́рынчигу
отвязать=тече́чугу
отвязаться от кого=токва́нгу
отгребать=гадо́лгу
отдавать о ружье=могне́ та́болгу
отдаваться=квере́нчигу
отдать учиться=на́гыртоголчо́лҗиле ми́гу
отделить=а́рын ю́дыгу
отделиться=малква́нгу
отдохнуть=ква́скальҗигу [исправлено из кваска́л ьҗигу]
отдохнуть сесть=ква́скальҗигу о́мдыгу
отдых=о́тдык
отец=э́зел
отказать=а́с ми́гу
отказаться=откази́мгу, а́с ква́нгу
откликаться=квэ́ргу
откликнуться=ла́нгалгу
отклониться=ко́кылгу
отколупнуть=то́гатолгу
откормить=путё́м а́бстембыгу
откормленный=путё́м а́бстембыди
открытие=ню́гумбыдимы
открыто делать=а́с та́умнымбыдимы
открыть=ти́дгу, ню́гу
откуда=куте́ндо
откусить=са́җигу
отличать=отличи́мгу
отличаться=лу́ччин э́зыгу
отложить=топе́нгу
отломить=мо́рку
отломиться=са́бытку, сепе́димгу
отмстить=аво́ймым ме́рчигу, аво́йзе могне́ ми́гу
отмщение=аво́ймым ме́рчимбыдимы
отодвинуть отодвинуться=теча́кол ьҗигу, кве́нч<а́> кол ьҗигу
отойти=токва́нгу, точа́жигу [ исправлено из точ а́җигу]
оторвать=ла́кчигу
оторваться=се́ппыдигу, ла́кчичугу
отпасть лист=пы́нгылгу, топы́кыльчигу
отпираться отпереться от чего=а́с катку́
отплыть=топа́льҗигу, то ква́нгу
отпор дать=кве́ссе те́ттыгу
отпроситься=ма́дырчигу
отпустить=ю́дыгу
отражать предметы лучи=те́лд аде́зигу
отражаться=тонче́н эту
отражаться в воде=ё́т аде́зигу, ю́тон ча́жекаги аде́зигу
отражение тени=тика́пая
отразить нападение=кве́ссете́ттыгу
отребье=атро́пка
отрекаться=ыэ́чьлазе а́с кы́гыгу
отрепья=атро́пка
отречься=откази́мгу
отрок=кыба́гом
отросток=чара́й по́
отряхнуть=чоба́лгу, ласке́етыгу
отсечь=келпача́лгу, окырпача́лгу
отставить=поне́ ме́лдчь мачко́льҗигу
отставить от дела=то ю́дыгу
отставной=тою́дымбыди
отставной солдат=солда́т ко́нте тю́мбан
отстать=токва́нгу
отступить=могне́ леле́дигу, могне́ чи́гальҗигу
отступить от кого=токва́нгу
отступить от слова от закона=зако́нан ас ме́гу, зако́нандо могне́леле́димгу
отсчитаться=то́гольҗигу
отсыреть=ю́дугу
отсюда=ты́ндо
оттепель=пёэ́земба
оттолкнуть=пере́лгу
оттолкнуться=но́голгу
отторгнуть=ла́кчигу
оттуда=наче́ндо
отчет=отчё́т
отъехать=токва́нгу
отыскать=коту
охладить=казе́етыгу
охотно=кыгыде́нзе
охотно=о́нде ко́ткат
охранять=караву́мбыгу
оцарапать=га́долгу
оценить=сени́мгу, ме́римчигу
оцепенеть=ко́ндалбыгу
очевидец=ку́д ко́нҗирбанъ, о́нде ко́нҗиркуд
очень=ка́ндыбынгъ, путё́м
очень длинный=канра́
очень старый человек=безме́рыэра́й го́м
очень тяжелый=тя́җелбат
очертить=по́зе ко́ромбыгу
очистить=нё́рбалгу
очиститься=нё́рбалчигу
очищение=нё́рбалбыдимы
ошибиться=мако́димгу
ошибка=мако́димба
пагубный=ква́ткуд
падать=пы́кыльчигу
падение=пы́кыльдико́ндимы
палец=му́н
палец ноги=то́пынму́н
палить покос=ча́дыгу
палка=по́
палка для лыж=чу́рр
палка посох=чу́рр
палочка=по́нби
пальник тетерька=сю́ва
память=па́мять
панги обувь=пе́у
пар=каш ко́у
парить орел=пю́ронгой ва́тöа
парное молоко=па́ргылба молоко́
парус=мергега́м
пасмурный=кашко́йди
пастись о скотине=а́ворле па́льдчигу
пастух пасет=пасту́к гани́мбан
паук=коча́пая
паутина=по́нгыпат
пахать=паха́йчигу
пахнуть=а́етигу
пашня=па́шня
пегий=пе́гай
пеленать ребенка=кыба́ ня́чам та́мгылгу
пена=си́боргна
пень=са́лдчь
первенстволюбец=куд пе́рванзе эту свыо́рыт
первый=пе́рвай
перевернуть=а́убликать питальҗигу
перевести переводить книгу=переводи́мгу
переворотиться=поро́льҗичигу
перевязывать перевязать=те́чикугу
перегородка=ара́н
передать=ми ту
передвигать=ча́кыльҗигу переднiй ́ня́нней
передний угол=Но́м а́мдете утолчь
передняя нога=уть
передовая=ня́нней
передразнивать=кве́ренҗигу
переехать реку=урлетё́чугу
перекликаться=па́ркугу
перекопать=сы́дымчелпакыледа́дыргу
перекреститься=кы́лыно́лымба́дельбыгу
перекресток=кресто́зын у́лиса ква́нбан
перелазить перелезть=че́реза́залгу
перелетный=ти́мбыди
переломить=ла́кчигу
перемена=переме́на перемöнить́ та́ргу
перемениться=а́рын метугу, а́с ны́льди метугу
перемешать=ко́дельдчигу
перенимать=ка́вальҗигу
переносить горе=терпи́мгу
переносить с моста=а́рын че́тчигу, то́голгу
переносье=пучино́лымба́р переобразоваться ́та́рчимбыгу
переплыть=у рлетё́чугу
перепрыгнуть=па́ктыгу
переселить=пересели́мгу
переселиться=пересели́тчигу
пересесть=а́вмын омдыту перескоскочить [вместо
перескочить=па́ктыгу
пересолить=ко́чин са́кыдгу
переспорить=спориса́тчимбан
перестать=уды ргу
переступить переступать=нельдчо́лдчигу, че́рез леле́димгу, че́рез а́залгу
перетаскать=ту́голгу
переулок=переу́лок
перешагнуть=а́залгу
перина=пери́на
перо=та́р
перо для письма=перо́
перстень=му нынгвоз
песня=ко́йм
песок=кора́
пестрый=пё́страй
петь=ко́тымбыгу
петь старинку=квэ́лҗимбыгу
печалиться=таску йчигу
печаль=печа́ль
печальный=а́ндалгыди
печать=печа́ть
печеный хлеб=ня́й мембыди
печень=ка́йно́л
печь=со́хоръ, пе́чка
печь в карамо=чува́л
печь хлеб=ня́ем мету
печься=забо́тимгу
пешком=утета́н
пещера=ко́вула
пила=ва́рг си́псен
пировать=ю́дгу, ара́нка ю́дгу на́да
писанный=на́гырбыдимы
писать=натенҗигу
письменное послание=натыр
письмо=натыр
питательный=ка́пучимбыдимы
питаться=пита́йса́тчигу
пить=ю́дыргу
питье=ю́дырбыдимы
пихта=ка́де
пища=а́бсот
пищание дудкой=ыэ́чьжимбыдимы
плавательное перо=ту́т
плавать=па́льдигу, ургу
плакать=чу рогу
пламенный огненный=тю́йзиди
пламень=тю́но́л
пламя=тю́й
плата за труды=пла́т труда́ст
платить=ме́рчигу
платок=ка́умбе
платье=пла́ти
плачь=чу ронъ, чу рымбыдимы
плеваться=све́зымбыгу плöнить́ па́ктыле ча́быгу
пленный=па́ктыле ча́бымбыди ко́м
плесень=пальча́
плесневеть=пальча́жлеча́жигу
плести=плети́мгу, па́ргу, па́тку
плетение=плети́ мбыдимы
плетенка=корзинка
плечо=кута́у, квандпа́р
плешивый=нё́лайо́ли
плод древесный=чо́быр
плодиться=ё́дыргу, ё́дырлеча́жигу
плодоносный=ко́ресю
плотва=пете́
плотный о материи=пло́тн<ый>, сво́мы
плоть=ва́ть
плоть бревна=пло́т
плут=во́риго́м
плюнуть плевать=све́зыгу
плясать=пакте́лбыгу
пляска=пакте́лбыдимы
по всему видно=се́лан а́дон
по голове=оло́унт [строка зачеркнута]
по дереву=по́гото́ндут [ строка зачеркнута]
по дорого=вато́гунт [строка зачеркнута]
по левую руку=кво́дблекат
по лицу=вандо́унт [строка зачеркнута]
по мере воры=ме́ранзе ве́рамъ, но́мт ве́рынэ́зын Но́м та́ткуд
по порядку=ма́стерынгъ, поря́дкам
по правую руку=та́дблекат
по природе=ни́льдинг те́лымбан
по пути=попути́
по руке=уто́унт [строка зачеркнута]
по совести=со́вестынзе
по человеку=го́мгойто́ндут [ строка зачеркнута]
по чему=о́унтъ, о́ндут (послö существительного]) [ строка зачеркнута]
по щеке ударить=ча́нҗ<и>епенква́тгу
по-братски=тимня́ сы́к
по-его=та́бтарэ́ [строка зачеркнута]
по-жидовски=жы́дысе́тчан [ строка зачеркнута]
по-моему=ма́нтарэ́ [строка зачеркнута]
по-остяцки=сю́ссогойсе́тчан [ строка зачеркнута]
по-прежнему=уко́льҗарэ́
по-русски=каза́гынсе́тчан [ строка зачеркнута]
по-своему=о́ндетарэ
по-татарски=ты́йсе́тчан [ строка зачеркнута]
по-твоему=та́нтарэ́ [строка зачеркнута]
по-тунгусски=тунгу́зсе́тчан [ строка зачеркнута]
по́мочь=по́мочь
победа=одоле́нья
победить=одоли́мгу
побои=ква́тбыдимы
побороть=ора́лгу ай э́стыгу
поваренка=кво́зкала
повернуться=койва́тку
повесить=э́тыгу
повести=ква́ннынбыгу
повешенный=э́тембыдимы
повивальная бабка=о́тон ко́м пая́
повиноваться=ю́нгольдчигу
повиновение=ю́нгольҗимбыдимы
повиснуть=ётерко́җигу
повод узды=по́вод
поворотить=тепи́кальҗигу
повредить=вреди́мгу
повстречаться=ко́гочигу
погибель=сме́рть, поги́бель
погибнуть=кулеча́жигу
погладить по голове=о́лымны'<н>галгу
погода ветер=пого́да
погодя немного=э́ттанг э́лебе
погонять=ка́ннингу
погреб=потреб
погребать=о́чимгу
погубить=катынбыгу
под=Ы'ЛЪ, Ы'ЛОГЫНЪ
под землею=тюны́логын
подавиться=сю́льгу, ноке́зигу
подарить=подари́нгу, ко́зынгу
подарок=ко́за
подать милостыню=ми́лостыням ми́гу
подать настоль=та́тку
подать пример=приме́р ми́гу
подбежать=тикуро́лгу
подбодриться=поҗо́льҗимбыгу, на́ркальҗигу
подбородок=пета́й
подвигать=ю́голгу
подвигаться=ня́ннен лаго́льҗигу подвизаться ́те́ттенбыгу
подвинуться=ча́кольҗигу
подговорить=ча́зыргу
поддаться=поддава́йчигу
поддерживать=орала́гынбыгу
поджать ноги=иннекаро́льҗигу
поджигать=ча́дыгу
поди прочь=тё́к ва́нк
подкошенный=па́чалбыди
подкрадываться=кво́нчигу
подкупить=та́угу
подкурить=кашко́льҗигу
подле=ко́йгынъ, кё́югей, коддерган
подлезть=ы́логынпа́тку
подлить=ещё га́мҗигу
подложить=ы́лотпе́нгу
подмерзать=канде́дигу
подмигнуть=се́ймд мыре́тчигу
поднебесный=нунсинче́ганы́лонди
поднести корту=а́гынт та́тку
поднимать=ва́тчигу
подниматься=ва́зыгу
поднос=подно́с
подносить гостям=та́больҗигу
поднять=ва́тчигу
поднять вверх=и́ннева́тчигу
поднять глаза=котте́ манҗе́зигу
поднять парусь=ме́ргега́м мизе́лгу
подняться=ва́тчичигу
подобие=ти́ка пая́
подогревать=пё́тчигу
пододвинуть=а́й а́внетчаго́льҗигу
подозвать=кво́релбыгу
подойти=табне́ ча́җигу, тю́нҗигу
подослать=ю́дыгу
подошва=то́пынылчь
подпереть=нуго́льҗигу
подпереться=нуго́льҗичугу
подпилок=си́пса
подпираться палкою=чу́ргольҗигу
подписаться=натыро́льҗигу
подпоясаться=кю́ндогу
подражатель=ны́льди жа ме́куд
подражать=ны́льди жа ме́гу
подраться=те́ттыгу, дра́кыса́тчигу
подружиться=дру́жна́н ю́бырлеэ́зыгу
подсвечник=посве́шник
подсматривать=тво́лакан ма́ннембыгу
подставить=илле́ндимачко́льҗигу
подтолкнуть=мизе́лгу
подустить подучить=оголчо́лҗигу, о́дальҗигу
подучить на зло=оголчо́лҗигу
подушка=ню'соготъ, поду́ска
подхватить=о́ралгу
подходить=тю́нҗигу
подчиниться=уто́гемызе ме́гугу
подъехать=тюлеми́дымбыгу
пожалеть=жале́имгу
пожар=пожа́р
позариться=поза́рингу
позвать=квэ́релбыгу
поздно=по́зно, ю́демыган
позевнуть=а́мымбыгу
познание=ко́стымбыдимы
поить=юто́льҗигу
поймать=оралпе́нҗигу, ора́лгу, ча́быгу
показать=а́дольҗигу
показываться=а́жигу ́ а́донъ, а́жизанъ, а́жемба, а́жич<а>н
покатиться=незо́лгу
поклониться=о́кыро́мдалгу
поклониться в ноги=то́пынды пы́нгыле о́мтыгу
поклониться в пояс=путё́м о́мтыгу
покоиться=кю́ган э́пегу
покойник=ката
покойно=поко́йнан е́нг
покойно жить=ма́стерынг э́лгу
покойный об умершем=поко́йник
поконаться=по́маралгу
покорить=покори́мгу
покориться=покори́тчигу
покорный=поко́рнай, ю́нгольҗимбыди
покоряться=ю́нгольҗигу, поко́рнан э́зыгу
покос=поко́с
покрытый сыпью=ча́рымбат
покрыть=ка́йгу
покумиться=кумау́гу
покупатель=тамты́н
покупать=та́мтыгу
пол=са́лҗипо
пол года=по́нтгос
полати=пола́ти
полдень=телдква́ска
поле=чи́стай ню́рт
ползать о животном=со́кыргу
ползать о человеке=незо́льҗимбыгу
ползающий=со́кордимы
полизать=ню́голгу
полка=по́р
полно накласть=чузети́ергу
полно налить=ти́ергу
полно насыпать=ти́ерлега́мҗигу
полный=ти́еримбыди
полным сделать=ти́ерлемегу
половина=ква́ска
пологий=ле́балаг е́нг
положить=пе́нгу
положить за пазуху=<о́>мгальҗе́нҗигу
положить на него руки=уто́н табни́ пе́нгу
положить на плечо=ме́ндалгу
положить на сошки ружье=по́ндапе́нгу
полосатый=чё́мбыгыт на́гы рымы
полотенце=ва́ндмыти
получить=получи́мбыгу
полынья=не́мба
польза=по́льза
пользовать=по́льзам мету
полюбить=свыо́ргу
помазание=ма́зимбыдимы
поместить в себе=па́дчигу
помешать чему=меша́ингу
поминать покойников=помина́имгу
поминки=помина́имбыдимы
помирить=мири́<т>чигу [зачеркнуто], мири́мгу
помириться=мириса́тчигу
помнить=тэ́йрбыгу
помочь помогать=помоги́мбыгу
помощник=пе́лдымкунди ко́мъ, помога́имбыди ко́мъ, помо́сник
помощь пособие=пе́лдымбыдимы
помрачить=лыба́н мету
помыслить=тэ́йрбыгу
помять=пе́ктылгу
поновить=са́ндын мету
поносить=ты́ндугу, ты́гу
понюхать=сижо́льҗимбыгу
понятно=понятно
понять=ко́стыгу пообöдать́ а́воргу
попадать на встречу=ко́гочимгу
попасть в ловушку=кё́тембыгу
попасть в сеть о рыбе=по́конд кво́дыгу
попасть в силок=кво́тымбыгу
попасть на камень=пю́ллага че́җимба
поперек=а́рт
попирать ногами=то́пызе нельдчо́лгу
попить=ю́доре́льчигу
пополнить=тíергу
попутный ветер=мого́л ме́рг
попутчик=поту́т<.>ик
попятиться=могне́ ча́кыльҗигу
пора вечерняя=ю́ди пора́
пора идти=пора́ ква́нгу
пора утренняя=ка́ри пора́
поработить=поработи́мгу
поработиться=пи́ремт уто́гемыгле ме́гу
порог=ма́дан до́б
поросенок=кыба́ сыбындя́
порох=по́рок
пороховница=атру́шка
портить обо всем=пана́лгу
порука=пору́ка
поручитель=паруча́имбыди ко́м
поручиться=поручи́мгу
порхать бабочка=ти́мбыгу
порядочный=поря́дошнай
посадить дерево=о́мдальҗигу
посветить=по́рчимбыгу
поселиться=сели́нгу, сели́тчигу
посетитель=чадзе́и ко́м
поскользнуться=не́зольдчигу
послать=ю́дыгу
после=капче́, мо́гоне́н
после этого=капче́ та́умы
последний=по́смогне́н
последовать=вато́унт ква́нгу
послезавтра=а́гдел
послушание=ю́нгольҗимбыдимы
послушать=ю́нгольҗигу
послушаться=ю́нгольҗимбыгу
послушно=послу́шнанг
послушный сын=ю́нгольҗимкунди и́дъ, сво́ и́д
посмотреть=ма́ннембельчигу
пособие=пе́лдымбыдимы
пособить=пе́лдыгу
посоветовать=сове́таимгу
посолить=сы́кыдгу, сы́кыдыльчигу
посох=чу́рр
поспел или нет обед=мю́зоромбанъ, а́ль а́с
посрамиться=стра́мнан э́зыгу
посредством=зе́
поставить выше всех=пы́ргын ве́сь гу́лан ны ́льҗигу
поставить кого=ны́льҗигу
поставить что=че́тчегу, мачько́льҗигу
постель=ча́нгозъ, ко́пт
постепенно=чё́нҗика́н
поститься=по́стутчигу
постлать=ча́нынбыгу
постой-ка=о́ла
постоять=а́с ку́ндынг ны́нгыгу [исправлено из а́с ва́рг ны́нгыгу]
постращать=ларчимбыгу
посылать=юде́нчигу
пот=нельдчутэ́
потемки=лы́бакан
потемнеть=лыба́н ме́гугу
потеря=ё́рчимбыдимы
потерянный=ё́рчимбыди
потерять=ё́рчигу
потеряться=ё́румбы гу
потеть=нельдчигу́
потихоньку=чё́нжиканг
потолок=потоло́к
потом=нынбле́
потомки=и́ндыла
потому=на́мывун
потому что=на́но, на́узе што́
потребовать=кво́ргу
потроха=кэ́т
потрясти=лаго́льдчигу
потушить=ка́птыгу
потушить пожарь=пожа́рымка́птыгу
потчевать попотчевать=по́тчиваингу
поужинать=а́воргу
похвала=а́ннымбыдимы
походить немного=та́ллепа́льдечигу
походка=па́льдин
похожие друг на друга=нэ́депю́ттиди
похожий=пю́тти
похоронить=карани́нгу, О'ЧИНГу
похотение=ва́тизиди кыгыде́
поцелуй=ни́дымбыдимы
почему=ка́йнго
почернеть=сетлагь э́зыгу
почерпнуть=со́голгу
почесть=че́сть
почет=че́сть
почетный житель=ка́жнай ко́м почита́имбат
починить=пра́вимгу
почка дерева=ка́на
почтенный=сво́ го́м
почти=всё равно́
пошатнуть=лаго́льҗигу
пошатнуть=о́кырынг лагыргу [исправлено из лагырчугу]
пошатнуться=че́пыкыльчигу
пошатнуться=о́кырынг [лагыр]чигу [исправлено из ́чугу]
пошел=ча́нҗемба
пощадить=жале́имгу
пощечина=ча́нҗибен ке́ттымбыдимы
пощупать=пю́гульҗигу
поэтому=та́умывун
поэтому то=та́умывун та
пояс=поя́ска, кю́
поясница=ку́ндемо, кю́ндемо
прабабушка=ещё ба́ушка
правая рука=та́де у́т
править=пра́вимбыгу
православный=правосла́внай
прадедушка=ещё де́душка
праздник=ну́льдзел
праздновать=нульдзе́льчигу
праздность=<асделазе́> э́зыгу
прать переть вперед=<пер>е́льҗигу
пребывать=завсегда́ э́гу
превозмочь=одоли́мгу
превратиться=метугу
преграда=ара́н
пред=га́тгенд
предание=ка́й и́ри гула ми́мбатъ, и́ри гула́ндо кура́льҗимбыдимы
предведение=ня́ннен ты́ннымбыди
предки=и́рикула
предполагать=ня́нненг тэ́йербыгу
предположение=ню́рбыдимы
предсказать=ня́нненг катку́
представить=та́тку
представить в уме=тэ́йрбыгу
предстатель=пе́лдымбыди го́м
предуведенный=могне́ ты́ннумбыди
предуведомить=уко́н катку́
предупредить=укон катку́
предшествовать=уко́лча́жигу
прежде=уко́нъ, ня́нненг
прежде !!!узна<...>=могне́ ты́ннумбыди
прежде других=уко́н а́урба
прежде нежели=уко́н на́умы, кунда́р
прежний=уко́й
презирать=ас свыо́ргу
преклонить голову=о́лонд мы́н кугу
прекословить=кё́гон че́нчигу
прекратить=у́тыргу
прекратиться=у́тырчигу прекращенiе ́у́тырбыдимы
прелестный=нра́винэ́стыкунди
прельститься=поза́рингу
премудрость=путё́м ва́рг тэ́й
препона=ара́н
препятствие=ара́н
препятствие в деле=аво́н о́мдальҗимбан
препятствовать=меса́имгу
преследовать=та́нгынбыгу
преступить=че́рез а́залгу
преступление=преступле́нья
преступник=через зако́н а́залкунди ко́мъ, преступник
преткнуться запнуться=табо́лгу, тапо́лбаты пы́кыльчигу
прибавить=приба́вимгу
прибежать=ме́нтетю́мбыгу
прибежать для защиты=ма́дыргу
прибежище=ку́ ква́нгу, ку¬ку ро́лгу
прибить гвоздями=ти́бынлазе ке́тыгу [исправлено из кё́ттенбыгу]
приблизиться=чардзе́кан э́зыгу, табни чажигу, табни́ ми́дыгу
прибодриться фертом=поҗо́льҗимбыгу, на́ркал ьҗигу
прибывать о воде=ме́чигу, мё́дзимбыгу
привалить=мачько́льҗигу
приведение=та́тбыдимы
привезти=та́тку
приветить=свыо́ргу
привлечь=ня́кыгу, та́ктылгу
приводить на память=тэ́ербыгу
привыкать привыкнуть=огуле́нҗигу
привязать=са́ргу
пригладить=гла́димгу
пригнать=ка́ннингу
пригнуть=ка́рольҗигу
пригоршни=сыдъо́ра
приготовить=гото́вимгу
приготовиться=гото́ван э́стыгу
придавать=еще ми́гу, прида́чам ми́гу
придавить чем=ча́нгро́льҗигу
приехать=тю́мбыгу, тю́гу
прижать=ы́пколгу
прижаться=то руко́льҗигу
призвание=квыа́рбыдимы
признать узнать=ко́стыгу, кё́тыльчигу
признаться=ка́тпыгу
призывать имя божие=Ну́нъ́ Н<е́ме> квыо́ргу
прийти=тю́гу, ми́дыгу
приказать=кура́льҗигу
приклеить=тутгу
приключение=ны́льди случай
прикоснуться=о́лао́ралгу
прикрепить=крепка́н мету
прикрытие=ка́ембыдимы
прикрыть прикрывать=а́с <ва́ргынъ> ка́йгу
прилагать=еще пе́нгу
прилежно=путё́м мету
прилежный=кытынди, трудиса́тчиндиго́м
прилепить=пока́льҗигу прилöпить́ парчугу
прилепиться=[пар]чичугу
прилететь=тю́гу
приложить=а́й пе́нгу, мач ко́льҗигу
приложиться из ружья=п<у́>д<о>лҗиле (пидо-, пудэ́, пидэ́, пегдо́, пегдэ-?) ча́лҗигу
прилучиться=случи́тчигу
применить к чему=та́рчигу
пример=приме́р
примерный=приме́рнай
примирение=мири́сатчимбыдимы
примирить=мири́нгу
примириться=мириса́тчигу
примотка=приме́тка
приневолить=заста́вимгу
принести=та́тку
принудить=заста́вимгу
принять пустить=ю́дыгу
приобрести=и́гу
приобретать=нажива́йчугу
приобщать ребенка=Ну́н юссе́ юто́льҗигу
приобщаться=Ну́н юссе́ ю́дырчигу
приобщаться святых тайн=Нун абсо́тым а́мгу
приплыть=у́рлекуптыгу
присесть=о́мдыгу
присматривать=ма́ннембыгу
причащаться святых тайн=Нун абсо́тым а́мгу
причесть=окырмыгы́н то́ренҗигу
причислить=окырмыгы́н то́ рэн җигу
пришить=сю́тку
пришить заплату=каби́ кабигу
пришлец=а́с ты́нди ко́мъ, а́рын ко́мъ, ку́д тю́мбанъ, тю́куд
пришпилить булавкой=со́нгыргу
прищемить=ы́пколгу
приятный на вкус=вку́снай
про́пасть=кра́льди нэ́и ча́нгван
пробираться=ква́ллеча́жигу
пробовать=про́баимгу
пробудиться=сы́дычигу
пробуждать=сы́дыгу
пробыть=э́гу
провалиться=пы́кыльчигу
проводить день=те́легенд ква́ддыгу
проводить жизнь=э́д<о>тде ква́ддыгу
провожать=ми́мокуро́лгу
провожать=понече́дчигу, проводи́мгу
проглотить=а́мгу, полле́чимбыгу
прогневлять=кво́дыльчигу
прогонять=ка́ннингу
прогуливаться=та́ллепа́льдчигу
продавать=ме́риргу
продавец купец=та́много́м
проданный=ме́римбыди
продать=ме́рылледа́дыргу
продираться=ква́ргылеча́жигу
продолговатый=чумбулаг енг
продолжать=а́й ко́ла мету
прожить деньги=тра́тимгу, тра́тиледа́дыргу
прозвать=кво́аргу
прозрачный=наскро́зь атра́н
прозрение=тру к се́йды ню́гучан
проиграть=ча́дчигу
произрастать=те́лынгеча́жигу
происшествие=ны́льди случай
пройти=ми́моча́җигу, ме́ндыгу
пройти две версты=ми́дыгу
пройти о времени=ме́нтыгу
проклинать=кыча́тчигу
прокол болезнь=кю́стимы
проколоть=че́резчоко́льҗигу
пролететь=вазе́чи́мбыгу
промахнуться=ы́к чарку ю́румбыгу ко́рын е́нг
промчаться=чанме́ттыгу
промысел звериный=су ри про́мысел
промысел рыбный=кво́лли про́мысел
пронзить=почо́льҗигу
пропадать=ю́рымбыгу
проплясать=пакте́лбы гу проповöдывать́ пропове́даимгу
пропустить=ю́дыгу
прорвать=ны́чкылгу
прорезать=ма́чьгу
прорицать=ня́ннен катку
прорубить=наскро́зь пача́лгу
прорубь=а́рамо
просветить=све́тлан ме́гу
просечь=че́резпа́челгу
просеять=лаге́ттыгу
просить=ма́дыргу, сотончагу [зачеркнуто]
просить милостыни=Ну мъды ма́дыргу
проситься=ма́дырчигу
прославиться=пи́ремт а́ндугу
прославленный=ква́ллимбыди
прославлять=а́ндугу, ква́ллимгу
прослезиться=чу рогу се́йндгай га́мҗигу
простить=кво́чьгу
проститься=прощайчигу
простодушный=та́дынче́нченг
простой человек=та́дынь го́м
просторный просторно=э́нгылье́нг
простота=простота́
пространно=ча́нҗенг
простудиться=простуди́тсан э́зыгу
просьба=про́сьба
протекать о реке=кё́нгугу
протереть глаза=се́йна́ткольҗигу
протесниться=ква́нгу
против=кё́гон ва́рка, кё́йгонд
против воды ехать=кю́унъ́ кве́се
противиться=а́с ю́нгольҗигу, кё́гон ны́нгыгу, кё́гон ква́нгу
противно=паган
противный ветер=кве́се ме́рг
проткнуть=через пожо́льҗигу, почо́льҗигу
протоптать дорогу=ва́тым тапчи́мгу
проторить=ча́нҗин не́льҗолгу
протрезвиться=подче́дигу
протянуть ноги=то́пынка́нгылгу
протянуться=ка́нгыльчигу
проучить=оголчо́лҗигу
прохладно=кыба́ а́рма те́лею́бырыт
прохладный=мерге́бчимбыди
прохладный о дне=те́лд ва́ргын пю́ а́с е́нг
прохлаждать=мерге́бчигу
процедить=нере́плида́дыргу
прошедший=ква́ндыкудъ, по́нду
прошение=про́сьба
прошлогодний=по́нгу под
прошлый=по́нду
прощай=проща́й
прощаться=проща́йчигу
прут=ма́к
прыгать=па́ктыргу
прыгнуть=па́ктыгу
прыжок=па́ктырбыдимы
прялка=пю́рчигужун
прямой=та́дын е́нг
прясть=се́гаммегу
птенцы=ийма́тлау
птица=ну нсу́рум
птичка=нунсу́румби
пугать=ла́рчигу, кэчо́льҗигу
пугаться=ла́рчимбыгу
пугливый=ла́рымбыди
пуговица=сыҗе́н
пузырь=мерсе́йпо
пузырь=сюзюго́жа
пуля=пуль
пустая дорога=пусто́й ва́т
пустить=ю́дыгу
пустой=сю́дзипюн е́нг
пустынная дорога=пусто́й ва́т
пух=пук
пуховый=пуксой
пушистый=чабырга́ е́нг
пчела=пчё́ла
пыж для заряда=пы́шка
пылить=пу ргыргу
пыль=пурга́ [зачеркнуто], качьку́
пыхтеть=си́жимбыгу
пьяница человек=юе́ренди го́м
пьяница ягода=ко́дык
пьяный=се́рбат
пятка=мо́тча, ы́рчит
работа=рабо́та
работать=работа́тчигу, у́чьгу, о́рчугу
работник=рабо́тнык
равночестный=ны́льди жа че́стнан е́нг
равный=о́кыр са́нье́н<г>
рад=а́нталбан
радоваться=а́нталбыгу
радостно=а́нталбле
радость=а́нталба, ра́дасть
радуга=ю́дерет четчу́жен
разбежаться=малкуро́лгу
разбежаться врозь=сытовасватку
разбросанный=точа́җимбыди
разбросать=ке́лынгу, тя́желгу
разбудить=сы́дыгу
разбудиться=сы́дычигу
развалиться=каве́дигу
разве=аразе́
развесить=ы́дгу
развести что=э́зыгу
развивать=са́нчелгу
развить=па́лгылгу
разворочать=уто́зе ке́лгу
развратить=по́рчимгу
развязать=те́чьчугу
разговаривать=келеда́дыргу
разграбить=то́лбыгу
разгрузить=конне́ мя́ктынгу
разгрызть=пу́чолгу
разгульный=разгу́льнай
раздавать вместо раздавить=че́лгынгу
раздавить=чи́кылгу
раздавить ногою=то́пызе чи́кылгу
раздать кому=ме́лалкынгу, ме́гылгу
раздать раздавать=миле́дадыргу
раздеваться=ня́выску
разделить=та́ргу
разделить пополам=та́ргу попола́м
разделиться=[та́р]чигу
разделиться разойтись=малква́нгу
раздражить=дразни́нгу
раздразнить=дразни́нгу
разжать руку=ча́ндчо́голгу, ню́гу
разжечь=ча́дыгу
разжечься=пи́ремт ча́дыгу
разживаться=ко́вулею́быргу
разинуть рот=ти́догу
разлить=га́мҗигу
разлиться=весь ча́нжалгу
различать=отличи́мгу
различный=ра́знай
разложить=ма́лпе́нгу
размножиться=ко́чин э́зыгу
размокнуть=ё́дымбыгу
размотаться=кондо́лбыгу
размочить=ёде́птегу, чабте́бтыгу
размякнуть=ёдо́умбыгу
разниться=а́с ня́мди пю́тти э́зыгу
разный=ра́знай
разобрать=разбира́имбыгу
разойтись=малква́нгу
разорвать одежды=нэча́рледа́дыргу
разорвать порохом=пасе́дигу
разорвать человека=нэча́ргу, ла́книгу
разорваться=ны́чкыльҗигу
разорваться с досады=ла́кчичугу
разоренье=разоре́нья
разорить=разори́мгу
разориться=[разори́м]чигу
разостлать=чанго́птымбыгу
разрешить вопрос=толкава́имгу
разрушить=каве́димгу
разуваться=ни́нку
разум=тэ́й
разуметь=тэ́йрбыгу
разъехаться=малква́нбыгу
разъяренный=си́льнан те́мбыди
рай=ра́ль
рама=ра́ма
рана боевая=ра́н
рана болезненная=пе́нк
ранить=ра́н ме́гу
рано=эрте́
раскалить=ня́рон по́рчигу
раскалиться=патчо́лгу
раскинуть=ко́ннымбыгу
расклониться=квоте́монгу
раскрыться=ню́гучигу
распалить=по́рчигу
распалиться=пи́ремт по́рчигу
распилить=пили́нгу
расплавить=ча́дыгу
распрягать лошадь=теса́нҗелгу
распугать=ла́рчигу
распялить=малня́кылгу
рассеивать зерна=малча́җигу
рассеиваться=ю́рле ма́льчигу
рассеяться=ё́ргу, ва́скватку
рассеяться дым=каш ко́й ю́румгу
рассеяться о людях=мал ква́нгу
рассказ=катка́лбыдимы
рассказать=ка́ткылгу, че́ннимбыгу
рассказать толком=па́ткылгу
расслабить=сла́бкан ме́гу
рассматривать=конне́мма́ннембыгу, ма́стерынг ма́ннембыгу
рассмотреть=ма́стерынг ма́ннембыгу
рассохнуться=чаге́нҗигу
расспрашивать=со́гончагу
расставить=малмачко́льҗигу
рассудительность=тэ́йербыдимы
рассучить нитки=могне́ че́бсыгу
рассыпать=камдечигу
рассыпаться=камде́чигу
рассыпчатый=че́имба
растаять=чу́гу, чулечугу
растерзать=ма́лнышкы́ргу
расти=о́рынгу
растлевать=пана́лгу, чу́к а́мбат
растлить=пана́лгу
растолковать=тэ́йзе толкова́имгу [исправлено из растолкова́имгу], толкова́имгу
растрепанный=ка́рлан е́нгъ, варса́лжимбыди
растрепать=варса́лҗигу
растянуться=чу́мбынка́нгыльҗигу
расчесывать=католеда́дыргу
ратовать=те́ттенбыгу
рвение=путё́м кыгыде́
ребенок детское название=пуба́
ребенок женского полу=не́йгом
ребенок мужеского полу=тебетом
ребенок общее название=са́дыка кыба́ го́м
ребра чресла подпоясать=пы́ргын кю́ндогу
ребро=ке́дыллы́
ребята=кыба́ ко́лау, ребята́у
ребятишки=кыба́мола́[ зачеркнуто], ребятишки
ребятушки=кыба́ гуламби [исправлено из гуламбiу], ребя́тамби [исправлено из ребя́тамбiу]
реветь=па́ркугу, ла́нгыску
ревнитель=стара́йчикуд
ревнительный=стара́йчимбыди
ревновать жену=ке́льҗигу
резать=ма́чьгу
резкий=ча́лынг
река=ква́й
река прошла=ква́йен ква́ненбат
ремень=чи́нгъ, ю́нь
репей=пу́дырган
ресница=се́йну́нд
речка=кё́
ржаветь=сы́рбагу
ржавчина=сы́рбадимы
ржать=ло́гонбыгу
робеть=кычва́тку
робкий=ла́рымбыди
робкий человек=муга́й ко́м
ров=ро́въ, кана́ва
ровесник годами=дру́к те́лынба́
ровесники ростом=ке́ндзяги
ровный=та́дын е́нгъ, о́кыр са́ньен
ровный о дорого=ура́нь
рога животного=а́мд
рога у вил=ча́ра
рогатина медвежья=су́ри пе́рчиса гво́з
рогатка деревянная=ча́ка
рогатый=а́мди
родившая родильница=инма́ты ко́мындат
родина=наче́н те́лымба
родители=э́ст а́ут
родитель=эзе́у
родить=ко́гу
родить о животных=ко́гу
родиться=те́лынбыгу
родник=тэ́р
родной=те́лынбыди
родственник=родня́у
рождать=ко́ку
рожок для ребенка=розо́к
ропот=кво́дымбыдимы
роптать=кво́дыгу [исправлено из кво́дымбыгу]
роса=ка́дамба, ча́бтъ, ча́бтыпы́нгылымынды
ростом=пыргы́тъ, пи́рыт
рот=а́нг
рубашка=ка́порг
рубить=па́четугу
ругатель=ты́мбыди ко́м
ругательство=ты́мбыдимы
ругать=ты́гу
ружейный курок=тю́льсен сакку
ружье=тульсэ́, тюльсэ́
ружье двуствольное=сыдство́лка
рука=уть
рукав=кола́н [исправлено из ко́ланъ]
рукавицы=но́п
руль=кормо́вой ла́п
румяный=ры́жай
русская женщина=каза́гне́йгом
русская земля=каза́гын чво́чь
русские люди=каза́гла
ручей=ручья́к
ручей материчный=кыгэ́
рыба=кво́л
рыбак=кво́лысба
рыбка=кво́лымби
рыдание=нега́ттын
рыдать=чу рогу не́гатчигу
рыжий=ры́жай
рыло=а́нг
рыситься о животном=нё́ргу
рысь зверь=ры́сь
рыть землю=католеда́дыргу
рыхлый=ка́гылбыди
рюмка=ча́рга
рябой=рябо́й го́м
рябчик=пэте
ряд ряды=ря́д
с=зе́ (послö существительного])
с издавна=кундо́кындо э́зын
сабля меч=тэта
сажа=ка́нд
сало=ё́р
сальное пятно=са́лазе ко́золомбан
сальный=са́лай [исправлено из сала́й]
сам=о́нд
сам себе=о́нде пире́гант
сам себя=о́нде пи́ремт
самовидец=о́нд ко́нҗиркудъ, ку́д о́нд ко́нҗирбан
сани=са́ни, ка́җи
сапоги=тапо́к
сбежать=каре́куро́лгу
сберечь=береги́мбыгу
сбирать ягоды=ква́дыгу
сбираться идти=ю́бычигу
сближаться=о́кырмынт ла́квангу, та́кылгу
ёрш=нырса́
